

PokerStars Game #24445211557:  Hold'em No Limit ($0.01/$0.02) - 2009/01/30 21:01:46 ET
Table 'Adalberta III' 9-max Seat #8 is the button
Seat 1: Gambler HA ($5.55 in chips) 
Seat 2: Philip Am ($1 in chips) 
Seat 3: ez.ronen ($1.98 in chips) 
Seat 4: mariam73 ($1.08 in chips) 
Seat 5: sunmt ($2 in chips) 
Seat 6: naturnerhart ($2.73 in chips) 
Seat 7: xxhewkoxx ($2.53 in chips) 
Seat 8: tranemaster ($3.69 in chips) 
Vastberaden will be allowed to play after the button
Gambler HA: posts small blind $0.01
Philip Am: posts big blind $0.02
sunmt: posts big blind $0.02
*** HOLE CARDS ***
Dealt to sunmt [9h Ks]
ez.ronen: folds 
Gambler HA said, "jo kurhaut"
mariam73: folds 
sunmt: checks 
naturnerhart: calls $0.02
xxhewkoxx: folds 
tranemaster: folds 
Gambler HA: folds 
Philip Am: checks 
*** FLOP *** [5h 8d Jd]
Philip Am: checks 
sunmt: checks 
naturnerhart: checks 
*** TURN *** [5h 8d Jd] [4h]
Philip Am: checks 
sunmt: checks 
naturnerhart: checks 
*** RIVER *** [5h 8d Jd 4h] [Ad]
Philip Am: checks 
sunmt: checks 
naturnerhart: checks 
*** SHOW DOWN ***
Philip Am: shows [6d 3s] (high card Ace)
sunmt: shows [9h Ks] (high card Ace - King kicker)
naturnerhart: shows [6c 8c] (a pair of Eights)
naturnerhart collected $0.07 from pot
*** SUMMARY ***
Total pot $0.07 | Rake $0 
Board [5h 8d Jd 4h Ad]
Seat 1: Gambler HA (small blind) folded before Flop
Seat 2: Philip Am (big blind) showed [6d 3s] and lost with high card Ace
Seat 3: ez.ronen folded before Flop (didn't bet)
Seat 4: mariam73 folded before Flop (didn't bet)
Seat 5: sunmt showed [9h Ks] and lost with high card Ace
Seat 6: naturnerhart showed [6c 8c] and won ($0.07) with a pair of Eights
Seat 7: xxhewkoxx folded before Flop (didn't bet)
Seat 8: tranemaster (button) folded before Flop (didn't bet)

PokerStars Game #24445252289:  Hold'em No Limit ($0.01/$0.02) - 2009/01/30 21:03:14 ET
Table 'Adalberta III' 9-max Seat #1 is the button
Seat 1: Gambler HA ($5.54 in chips) 
Seat 2: Philip Am ($1 in chips) 
Seat 3: ez.ronen ($1.98 in chips) 
Seat 4: mariam73 ($1.08 in chips) 
Seat 5: sunmt ($1.98 in chips) 
Seat 6: naturnerhart ($2.78 in chips) 
Seat 7: xxhewkoxx ($2.53 in chips) 
Seat 8: tranemaster ($3.69 in chips) 
Seat 9: Vastberaden ($1 in chips) 
Philip Am: posts small blind $0.01
ez.ronen: posts big blind $0.02
Vastberaden: posts small & big blinds $0.03
*** HOLE CARDS ***
Dealt to sunmt [8c 6s]
mariam73: calls $0.02
sunmt: folds 
naturnerhart: calls $0.02
xxhewkoxx: folds 
tranemaster: folds 
Vastberaden: checks 
Gambler HA: calls $0.02
Philip Am: calls $0.01
ez.ronen: checks 
*** FLOP *** [2h Qd Jh]
Philip Am: checks 
ez.ronen: bets $0.02
mariam73: calls $0.02
naturnerhart: folds 
Vastberaden: folds 
Vastberaden leaves the table
Gambler HA: raises $0.08 to $0.10
Philip Am: folds 
ez.ronen: calls $0.08
sapopez joins the table at seat #9 
mariam73: calls $0.08
*** TURN *** [2h Qd Jh] [Ts]
ez.ronen: checks 
mariam73: checks 
Gambler HA: bets $0.06
ez.ronen: calls $0.06
mariam73: folds 
*** RIVER *** [2h Qd Jh Ts] [Ad]
ez.ronen: checks 
Gambler HA: checks 
*** SHOW DOWN ***
ez.ronen: shows [2d Qh] (two pair, Queens and Deuces)
Gambler HA: mucks hand 
ez.ronen collected $0.55 from pot
*** SUMMARY ***
Total pot $0.55 | Rake $0 
Board [2h Qd Jh Ts Ad]
Seat 1: Gambler HA (button) mucked [Qc 6h]
Seat 2: Philip Am (small blind) folded on the Flop
Seat 3: ez.ronen (big blind) showed [2d Qh] and won ($0.55) with two pair, Queens and Deuces
Seat 4: mariam73 folded on the Turn
Seat 5: sunmt folded before Flop (didn't bet)
Seat 6: naturnerhart folded on the Flop
Seat 7: xxhewkoxx folded before Flop (didn't bet)
Seat 8: tranemaster folded before Flop (didn't bet)
Seat 9: Vastberaden folded on the Flop



PokerStars Game #24445295002:  Hold'em No Limit ($0.01/$0.02) - 2009/01/30 21:04:46 ET
Table 'Adalberta III' 9-max Seat #2 is the button
Seat 1: Gambler HA ($5.36 in chips) 
Seat 2: Philip Am ($1 in chips) 
Seat 3: ez.ronen ($2.35 in chips) 
Seat 4: mariam73 ($0.96 in chips) 
Seat 5: sunmt ($1.98 in chips) 
Seat 6: naturnerhart ($2.76 in chips) 
Seat 7: xxhewkoxx ($2.53 in chips) 
Seat 8: tranemaster ($3.69 in chips) 
ez.ronen: posts small blind $0.01
mariam73: posts big blind $0.02
sapopez: sits out 
*** HOLE CARDS ***
Dealt to sunmt [Qs 3s]
sunmt: folds 
naturnerhart: folds 
xxhewkoxx: calls $0.02
tranemaster: folds 
Gambler HA: folds 
Philip Am: folds 
ez.ronen: calls $0.01
mariam73: checks 
*** FLOP *** [3c Jh 4h]
ez.ronen: checks 
mariam73: checks 
xxhewkoxx: checks 
*** TURN *** [3c Jh 4h] [Th]
ez.ronen: checks 
mariam73: checks 
xxhewkoxx: bets $0.02
ez.ronen: calls $0.02
mariam73: folds 
*** RIVER *** [3c Jh 4h Th] [6d]
ez.ronen: checks 
xxhewkoxx: checks 
*** SHOW DOWN ***
ez.ronen: shows [4c Kc] (a pair of Fours)
xxhewkoxx: shows [4d As] (a pair of Fours - Ace kicker)
xxhewkoxx collected $0.10 from pot
*** SUMMARY ***
Total pot $0.10 | Rake $0 
Board [3c Jh 4h Th 6d]
Seat 1: Gambler HA folded before Flop (didn't bet)
Seat 2: Philip Am (button) folded before Flop (didn't bet)
Seat 3: ez.ronen (small blind) showed [4c Kc] and lost with a pair of Fours
Seat 4: mariam73 (big blind) folded on the Turn
Seat 5: sunmt folded before Flop (didn't bet)
Seat 6: naturnerhart folded before Flop (didn't bet)
Seat 7: xxhewkoxx showed [4d As] and won ($0.10) with a pair of Fours
Seat 8: tranemaster folded before Flop (didn't bet)



PokerStars Game #24445337917:  Hold'em No Limit ($0.01/$0.02) - 2009/01/30 21:06:19 ET
Table 'Adalberta III' 9-max Seat #3 is the button
Seat 1: Gambler HA ($5.36 in chips) 
Seat 2: Philip Am ($1 in chips) 
Seat 3: ez.ronen ($2.31 in chips) 
Seat 4: mariam73 ($0.94 in chips) 
Seat 5: sunmt ($1.98 in chips) 
Seat 6: naturnerhart ($2.76 in chips) 
Seat 7: xxhewkoxx ($2.59 in chips) 
Seat 8: tranemaster ($3.69 in chips) 
mariam73: posts small blind $0.01
sunmt: posts big blind $0.02
sapopez: sits out 
*** HOLE CARDS ***
Dealt to sunmt [8c Ks]
naturnerhart: folds 
xxhewkoxx: calls $0.02
tranemaster: folds 
Gambler HA: folds 
Philip Am: folds 
ez.ronen: folds 
mariam73: calls $0.01
sunmt: checks 
*** FLOP *** [2h 9d Qc]
mariam73: checks 
sunmt: checks 
xxhewkoxx: checks 
*** TURN *** [2h 9d Qc] [6h]
mariam73: checks 
sunmt: checks 
xxhewkoxx: checks 
*** RIVER *** [2h 9d Qc 6h] [Kd]
mariam73: checks 
sunmt: bets $0.02
xxhewkoxx: folds 
mariam73: calls $0.02
*** SHOW DOWN ***
sunmt: shows [8c Ks] (a pair of Kings)
mariam73: mucks hand 
sunmt collected $0.10 from pot
*** SUMMARY ***
Total pot $0.10 | Rake $0 
Board [2h 9d Qc 6h Kd]
Seat 1: Gambler HA folded before Flop (didn't bet)
Seat 2: Philip Am folded before Flop (didn't bet)
Seat 3: ez.ronen (button) folded before Flop (didn't bet)
Seat 4: mariam73 (small blind) mucked [5c Ac]
Seat 5: sunmt (big blind) showed [8c Ks] and won ($0.10) with a pair of Kings
Seat 6: naturnerhart folded before Flop (didn't bet)
Seat 7: xxhewkoxx folded on the River
Seat 8: tranemaster folded before Flop (didn't bet)



PokerStars Game #24445369765:  Hold'em No Limit ($0.01/$0.02) - 2009/01/30 21:07:29 ET
Table 'Adalberta III' 9-max Seat #4 is the button
Seat 1: Gambler HA ($5.36 in chips) 
Seat 2: Philip Am ($1 in chips) 
Seat 3: ez.ronen ($2.31 in chips) 
Seat 4: mariam73 ($0.90 in chips) 
Seat 5: sunmt ($2.04 in chips) 
Seat 6: naturnerhart ($2.76 in chips) 
Seat 7: xxhewkoxx ($2.57 in chips) 
Seat 8: tranemaster ($3.69 in chips) 
Seat 9: sapopez ($3 in chips) 
sunmt: posts small blind $0.01
naturnerhart: posts big blind $0.02
sapopez: posts big blind $0.02
*** HOLE CARDS ***
Dealt to sunmt [6d Kc]
xxhewkoxx: calls $0.02
tranemaster: calls $0.02
sapopez: checks 
Gambler HA: calls $0.02
Philip Am: folds 
ez.ronen: folds 
mariam73: calls $0.02
sunmt: folds 
naturnerhart: checks 
*** FLOP *** [Ts 9d 4c]
naturnerhart: checks 
xxhewkoxx: bets $0.02
tranemaster: calls $0.02
sapopez: calls $0.02
Gambler HA: calls $0.02
mariam73: calls $0.02
naturnerhart: folds 
*** TURN *** [Ts 9d 4c] [6h]
xxhewkoxx: bets $0.02
tranemaster: folds 
sapopez: calls $0.02
Gambler HA: calls $0.02
mariam73: folds 
*** RIVER *** [Ts 9d 4c 6h] [Ks]
xxhewkoxx: bets $0.02
sapopez: raises $0.14 to $0.16
Gambler HA: folds 
xxhewkoxx: folds 
Uncalled bet ($0.14) returned to sapopez
sapopez collected $0.33 from pot
sapopez: doesn't show hand 
*** SUMMARY ***
Total pot $0.33 | Rake $0 
Board [Ts 9d 4c 6h Ks]
Seat 1: Gambler HA folded on the River
Seat 2: Philip Am folded before Flop (didn't bet)
Seat 3: ez.ronen folded before Flop (didn't bet)
Seat 4: mariam73 (button) folded on the Turn
Seat 5: sunmt (small blind) folded before Flop
Seat 6: naturnerhart (big blind) folded on the Flop
Seat 7: xxhewkoxx folded on the River
Seat 8: tranemaster folded on the Turn
Seat 9: sapopez collected ($0.33)



PokerStars Game #24445431014:  Hold'em No Limit ($0.01/$0.02) - 2009/01/30 21:09:41 ET
Table 'Adalberta III' 9-max Seat #5 is the button
Seat 1: Gambler HA ($5.30 in chips) 
Seat 2: Philip Am ($1 in chips) 
Seat 3: ez.ronen ($2.31 in chips) 
Seat 4: mariam73 ($0.86 in chips) 
Seat 5: sunmt ($2.03 in chips) 
Seat 6: naturnerhart ($2.74 in chips) 
Seat 7: xxhewkoxx ($2.49 in chips) 
Seat 8: tranemaster ($3.65 in chips) 
Seat 9: sapopez ($3.25 in chips) 
naturnerhart: posts small blind $0.01
xxhewkoxx: posts big blind $0.02
*** HOLE CARDS ***
Dealt to sunmt [5d Js]
tranemaster: calls $0.02
sapopez: folds 
Gambler HA: folds 
Philip Am: raises $0.08 to $0.10
ez.ronen: folds 
mariam73: folds 
sunmt: folds 
naturnerhart: calls $0.09
xxhewkoxx: folds 
tranemaster: folds 
*** FLOP *** [Kd 8c Ah]
naturnerhart: checks 
Philip Am: bets $0.16
naturnerhart: calls $0.16
*** TURN *** [Kd 8c Ah] [2s]
naturnerhart: bets $2.48 and is all-in
Philip Am: folds 
Uncalled bet ($2.48) returned to naturnerhart
naturnerhart collected $0.56 from pot
*** SUMMARY ***
Total pot $0.56 | Rake $0 
Board [Kd 8c Ah 2s]
Seat 1: Gambler HA folded before Flop (didn't bet)
Seat 2: Philip Am folded on the Turn
Seat 3: ez.ronen folded before Flop (didn't bet)
Seat 4: mariam73 folded before Flop (didn't bet)
Seat 5: sunmt (button) folded before Flop (didn't bet)
Seat 6: naturnerhart (small blind) collected ($0.56)
Seat 7: xxhewkoxx (big blind) folded before Flop
Seat 8: tranemaster folded before Flop
Seat 9: sapopez folded before Flop (didn't bet)



PokerStars Game #24445464540:  Hold'em No Limit ($0.01/$0.02) - 2009/01/30 21:10:54 ET
Table 'Adalberta III' 9-max Seat #6 is the button
Seat 1: Gambler HA ($5.30 in chips) 
Seat 2: Philip Am ($1 in chips) 
Seat 3: ez.ronen ($2.31 in chips) 
Seat 4: mariam73 ($0.86 in chips) 
Seat 5: sunmt ($2.03 in chips) 
Seat 6: naturnerhart ($3.04 in chips) 
Seat 7: xxhewkoxx ($2.47 in chips) 
Seat 8: tranemaster ($3.63 in chips) 
Seat 9: sapopez ($3.25 in chips) 
xxhewkoxx: posts small blind $0.01
tranemaster: posts big blind $0.02
*** HOLE CARDS ***
Dealt to sunmt [9s 6c]
Gambler HA said, "zzzzz"
sapopez has timed out
sapopez: folds 
sapopez is sitting out
Gambler HA: raises $0.08 to $0.10
Philip Am: folds 
ez.ronen: folds 
mariam73: folds 
sunmt: folds 
naturnerhart: folds 
naturnerhart leaves the table
sapopez has returned
xxhewkoxx: calls $0.09
rideraa joins the table at seat #6 
tranemaster: folds 
*** FLOP *** [5d Jc 7h]
xxhewkoxx: checks 
Gambler HA: bets $0.10
xxhewkoxx: calls $0.10
*** TURN *** [5d Jc 7h] [Kc]
xxhewkoxx: checks 
Gambler HA: checks 
*** RIVER *** [5d Jc 7h Kc] [2h]
xxhewkoxx: bets $0.18
Gambler HA: calls $0.18
*** SHOW DOWN ***
xxhewkoxx: shows [7c 9c] (a pair of Sevens)
Gambler HA: mucks hand 
xxhewkoxx collected $0.78 from pot
*** SUMMARY ***
Total pot $0.78 | Rake $0 
Board [5d Jc 7h Kc 2h]
Seat 1: Gambler HA mucked [Qc As]
Seat 2: Philip Am folded before Flop (didn't bet)
Seat 3: ez.ronen folded before Flop (didn't bet)
Seat 4: mariam73 folded before Flop (didn't bet)
Seat 5: sunmt folded before Flop (didn't bet)
Seat 6: naturnerhart (button) folded before Flop (didn't bet)
Seat 7: xxhewkoxx (small blind) showed [7c 9c] and won ($0.78) with a pair of Sevens
Seat 8: tranemaster (big blind) folded before Flop
Seat 9: sapopez folded before Flop (didn't bet)



PokerStars Game #24445508877:  Hold'em No Limit ($0.01/$0.02) - 2009/01/30 21:12:29 ET
Table 'Adalberta III' 9-max Seat #7 is the button
Seat 1: Gambler HA ($4.92 in chips) 
Seat 2: Philip Am ($1 in chips) 
Seat 3: ez.ronen ($2.31 in chips) 
Seat 4: mariam73 ($0.86 in chips) 
Seat 5: sunmt ($2.03 in chips) 
Seat 7: xxhewkoxx ($2.87 in chips) 
Seat 8: tranemaster ($3.61 in chips) 
Seat 9: sapopez ($3.25 in chips) 
tranemaster: posts small blind $0.01
sapopez: posts big blind $0.02
rideraa: sits out 
*** HOLE CARDS ***
Dealt to sunmt [3c 2d]
Gambler HA: calls $0.02
Philip Am: raises $0.08 to $0.10
ez.ronen: folds 
mariam73: folds 
sunmt: folds 
xxhewkoxx: folds 
tranemaster: folds 
Gambler HA said, "sap are you sleeping??"
sapopez: folds 
Gambler HA: calls $0.08
*** FLOP *** [7s Ts Th]
Gambler HA: bets $0.02
sapopez said, "i play other tables"
Philip Am: raises $0.16 to $0.18
Gambler HA: calls $0.16
*** TURN *** [7s Ts Th] [4s]
Gambler HA: checks 
Philip Am: bets $0.40
Gambler HA: folds 
Uncalled bet ($0.40) returned to Philip Am
Philip Am collected $0.59 from pot
Philip Am: doesn't show hand 
*** SUMMARY ***
Total pot $0.59 | Rake $0 
Board [7s Ts Th 4s]
Seat 1: Gambler HA folded on the Turn
Seat 2: Philip Am collected ($0.59)
Seat 3: ez.ronen folded before Flop (didn't bet)
Seat 4: mariam73 folded before Flop (didn't bet)
Seat 5: sunmt folded before Flop (didn't bet)
Seat 7: xxhewkoxx (button) folded before Flop (didn't bet)
Seat 8: tranemaster (small blind) folded before Flop
Seat 9: sapopez (big blind) folded before Flop



PokerStars Game #24445558100:  Hold'em No Limit ($0.01/$0.02) - 2009/01/30 21:14:16 ET
Table 'Adalberta III' 9-max Seat #8 is the button
Seat 1: Gambler HA ($4.64 in chips) 
Seat 2: Philip Am ($1.31 in chips) 
Seat 3: ez.ronen ($2.31 in chips) 
Seat 4: mariam73 ($0.86 in chips) 
Seat 5: sunmt ($2.03 in chips) 
Seat 7: xxhewkoxx ($2.87 in chips) 
Seat 8: tranemaster ($3.60 in chips) 
Seat 9: sapopez ($3.23 in chips) 
sapopez: posts small blind $0.01
Gambler HA: posts big blind $0.02
rideraa: sits out 
*** HOLE CARDS ***
Dealt to sunmt [7s Ad]
Philip Am: folds 
ez.ronen: calls $0.02
mariam73: calls $0.02
sunmt: folds 
xxhewkoxx: folds 
tranemaster: folds 
sapopez: folds 
Gambler HA: checks 
*** FLOP *** [5c 6h 5s]
Gambler HA: bets $0.06
ez.ronen: folds 
mariam73: folds 
Uncalled bet ($0.06) returned to Gambler HA
Gambler HA collected $0.07 from pot
Gambler HA: doesn't show hand 
*** SUMMARY ***
Total pot $0.07 | Rake $0 
Board [5c 6h 5s]
Seat 1: Gambler HA (big blind) collected ($0.07)
Seat 2: Philip Am folded before Flop (didn't bet)
Seat 3: ez.ronen folded on the Flop
Seat 4: mariam73 folded on the Flop
Seat 5: sunmt folded before Flop (didn't bet)
Seat 7: xxhewkoxx folded before Flop (didn't bet)
Seat 8: tranemaster (button) folded before Flop (didn't bet)
Seat 9: sapopez (small blind) folded before Flop



PokerStars Game #24445587593:  Hold'em No Limit ($0.01/$0.02) - 2009/01/30 21:15:19 ET
Table 'Adalberta III' 9-max Seat #9 is the button
Seat 1: Gambler HA ($5 in chips) 
Seat 2: Philip Am ($1.31 in chips) 
Seat 3: ez.ronen ($2.29 in chips) 
Seat 4: mariam73 ($0.84 in chips) 
Seat 5: sunmt ($2.03 in chips) 
Seat 7: xxhewkoxx ($2.87 in chips) 
Seat 8: tranemaster ($3.60 in chips) 
Seat 9: sapopez ($3.22 in chips) 
Gambler HA: posts small blind $0.01
Philip Am: posts big blind $0.02
rideraa: sits out 
*** HOLE CARDS ***
Dealt to sunmt [9d Jd]
ez.ronen: calls $0.02
mariam73: calls $0.02
sunmt: folds 
xxhewkoxx: folds 
tranemaster: folds 
sapopez: folds 
Gambler HA: calls $0.01
Philip Am: checks 
*** FLOP *** [8s 7s As]
Gambler HA: checks 
Philip Am: checks 
ez.ronen: checks 
mariam73: bets $0.02
Gambler HA: folds 
Philip Am: folds 
ez.ronen: calls $0.02
*** TURN *** [8s 7s As] [Ac]
ez.ronen: checks 
mariam73: bets $0.04
ez.ronen: calls $0.04
*** RIVER *** [8s 7s As Ac] [Js]
ez.ronen: checks 
mariam73: bets $0.10
Gambler HA is sitting out
ez.ronen: folds 
Uncalled bet ($0.10) returned to mariam73
mariam73 collected $0.20 from pot
mariam73: doesn't show hand 
*** SUMMARY ***
Total pot $0.20 | Rake $0 
Board [8s 7s As Ac Js]
Seat 1: Gambler HA (small blind) folded on the Flop
Seat 2: Philip Am (big blind) folded on the Flop
Seat 3: ez.ronen folded on the River
Seat 4: mariam73 collected ($0.20)
Seat 5: sunmt folded before Flop (didn't bet)
Seat 7: xxhewkoxx folded before Flop (didn't bet)
Seat 8: tranemaster folded before Flop (didn't bet)
Seat 9: sapopez (button) folded before Flop (didn't bet)



PokerStars Game #24445621198:  Hold'em No Limit ($0.01/$0.02) - 2009/01/30 21:16:31 ET
Table 'Adalberta III' 9-max Seat #2 is the button
Seat 2: Philip Am ($1.29 in chips) 
Seat 3: ez.ronen ($2.21 in chips) 
Seat 4: mariam73 ($0.96 in chips) 
Seat 5: sunmt ($2.03 in chips) 
Seat 7: xxhewkoxx ($2.87 in chips) 
Seat 8: tranemaster ($3.60 in chips) 
Seat 9: sapopez ($3.22 in chips) 
ez.ronen: posts small blind $0.01
mariam73: posts big blind $0.02
rideraa: sits out 
*** HOLE CARDS ***
Dealt to sunmt [Ts 2h]
sunmt: folds 
xxhewkoxx: folds 
tranemaster: folds 
sapopez: raises $0.06 to $0.08
Philip Am: folds 
ez.ronen: folds 
mariam73: folds 
Uncalled bet ($0.06) returned to sapopez
sapopez collected $0.05 from pot
sapopez: doesn't show hand 
*** SUMMARY ***
Total pot $0.05 | Rake $0 
Seat 2: Philip Am (button) folded before Flop (didn't bet)
Seat 3: ez.ronen (small blind) folded before Flop
Seat 4: mariam73 (big blind) folded before Flop
Seat 5: sunmt folded before Flop (didn't bet)
Seat 7: xxhewkoxx folded before Flop (didn't bet)
Seat 8: tranemaster folded before Flop (didn't bet)
Seat 9: sapopez collected ($0.05)



PokerStars Game #24445632977:  Hold'em No Limit ($0.01/$0.02) - 2009/01/30 21:16:56 ET
Table 'Adalberta III' 9-max Seat #3 is the button
Seat 2: Philip Am ($1.29 in chips) 
Seat 3: ez.ronen ($2.20 in chips) 
Seat 4: mariam73 ($0.94 in chips) 
Seat 5: sunmt ($2.03 in chips) 
Seat 7: xxhewkoxx ($2.87 in chips) 
Seat 8: tranemaster ($3.60 in chips) 
Seat 9: sapopez ($3.25 in chips) 
mariam73: posts small blind $0.01
sunmt: posts big blind $0.02
rideraa: sits out 
*** HOLE CARDS ***
Dealt to sunmt [Js 9h]
xxhewkoxx: folds 
tranemaster: folds 
tranemaster is sitting out
sapopez: folds 
Philip Am: folds 
ez.ronen: calls $0.02
mariam73: calls $0.01
sunmt: checks 
*** FLOP *** [4s Kc Jh]
mariam73: checks 
sunmt: checks 
ez.ronen: bets $0.02
mariam73: folds 
sunmt: folds 
Uncalled bet ($0.02) returned to ez.ronen
ez.ronen collected $0.06 from pot
ez.ronen: doesn't show hand 
*** SUMMARY ***
Total pot $0.06 | Rake $0 
Board [4s Kc Jh]
Seat 2: Philip Am folded before Flop (didn't bet)
Seat 3: ez.ronen (button) collected ($0.06)
Seat 4: mariam73 (small blind) folded on the Flop
Seat 5: sunmt (big blind) folded on the Flop
Seat 7: xxhewkoxx folded before Flop (didn't bet)
Seat 8: tranemaster folded before Flop (didn't bet)
Seat 9: sapopez folded before Flop (didn't bet)



PokerStars Game #24445661380:  Hold'em No Limit ($0.01/$0.02) - 2009/01/30 21:17:57 ET
Table 'Adalberta III' 9-max Seat #4 is the button
Seat 2: Philip Am ($1.29 in chips) 
Seat 3: ez.ronen ($2.24 in chips) 
Seat 4: mariam73 ($0.92 in chips) 
Seat 5: sunmt ($2.01 in chips) 
Seat 6: rideraa ($5 in chips) 
Seat 7: xxhewkoxx ($2.87 in chips) 
Seat 9: sapopez ($3.25 in chips) 
sunmt: posts small blind $0.01
rideraa: posts big blind $0.02
*** HOLE CARDS ***
Dealt to sunmt [Kc 6s]
xxhewkoxx: calls $0.02
sapopez: folds 
Philip Am: folds 
ez.ronen: calls $0.02
mariam73: raises $0.02 to $0.04
sunmt: folds 
rideraa: folds 
xxhewkoxx: calls $0.02
ez.ronen: calls $0.02
*** FLOP *** [4d 9s 9h]
xxhewkoxx: checks 
ez.ronen: checks 
mariam73: bets $0.10
xxhewkoxx: folds 
ez.ronen: folds 
Uncalled bet ($0.10) returned to mariam73
mariam73 collected $0.15 from pot
mariam73: doesn't show hand 
*** SUMMARY ***
Total pot $0.15 | Rake $0 
Board [4d 9s 9h]
Seat 2: Philip Am folded before Flop (didn't bet)
Seat 3: ez.ronen folded on the Flop
Seat 4: mariam73 (button) collected ($0.15)
Seat 5: sunmt (small blind) folded before Flop
Seat 6: rideraa (big blind) folded before Flop
Seat 7: xxhewkoxx folded on the Flop
Seat 9: sapopez folded before Flop (didn't bet)



PokerStars Game #24445698507:  Hold'em No Limit ($0.01/$0.02) - 2009/01/30 21:19:17 ET
Table 'Adalberta III' 9-max Seat #5 is the button
Seat 2: Philip Am ($1.29 in chips) 
Seat 3: ez.ronen ($2.20 in chips) 
Seat 4: mariam73 ($1.03 in chips) 
Seat 5: sunmt ($2 in chips) 
Seat 6: rideraa ($4.98 in chips) 
Seat 7: xxhewkoxx ($2.83 in chips) 
Seat 9: sapopez ($3.25 in chips) 
rideraa: posts small blind $0.01
xxhewkoxx: posts big blind $0.02
*** HOLE CARDS ***
Dealt to sunmt [Qd Js]
sapopez: folds 
Philip Am: folds 
ez.ronen: calls $0.02
mariam73: raises $0.02 to $0.04
sunmt: folds 
rideraa: folds 
xxhewkoxx: calls $0.02
ez.ronen: calls $0.02
*** FLOP *** [4h Jc Kd]
xxhewkoxx: checks 
ez.ronen: checks 
tranemaster has returned
mariam73: bets $0.10
xxhewkoxx: calls $0.10
ez.ronen: folds 
*** TURN *** [4h Jc Kd] [6h]
xxhewkoxx: checks 
mariam73: bets $0.10
xxhewkoxx: calls $0.10
*** RIVER *** [4h Jc Kd 6h] [Ks]
xxhewkoxx: checks 
mariam73: bets $0.16
xxhewkoxx: raises $0.48 to $0.64
mariam73: raises $0.15 to $0.79 and is all-in
xxhewkoxx: calls $0.15
*** SHOW DOWN ***
mariam73: shows [As Kh] (three of a kind, Kings)
xxhewkoxx: mucks hand 
mariam73 collected $2.01 from pot
*** SUMMARY ***
Total pot $2.11 | Rake $0.10 
Board [4h Jc Kd 6h Ks]
Seat 2: Philip Am folded before Flop (didn't bet)
Seat 3: ez.ronen folded on the Flop
Seat 4: mariam73 showed [As Kh] and won ($2.01) with three of a kind, Kings
Seat 5: sunmt (button) folded before Flop (didn't bet)
Seat 6: rideraa (small blind) folded before Flop
Seat 7: xxhewkoxx (big blind) mucked [Ah Jd]
Seat 9: sapopez folded before Flop (didn't bet)



PokerStars Game #24445750037:  Hold'em No Limit ($0.01/$0.02) - 2009/01/30 21:21:09 ET
Table 'Adalberta III' 9-max Seat #6 is the button
Seat 2: Philip Am ($1.29 in chips) 
Seat 3: ez.ronen ($2.16 in chips) 
Seat 4: mariam73 ($2.01 in chips) 
Seat 5: sunmt ($2 in chips) 
Seat 6: rideraa ($4.97 in chips) 
Seat 7: xxhewkoxx ($1.80 in chips) 
Seat 8: tranemaster ($3.60 in chips) 
Seat 9: sapopez ($3.25 in chips) 
xxhewkoxx: posts small blind $0.01
tranemaster: posts big blind $0.02
*** HOLE CARDS ***
Dealt to sunmt [Jh 5h]
sapopez: calls $0.02
Philip Am: folds 
ez.ronen: folds 
mariam73: calls $0.02
sunmt: folds 
rideraa: calls $0.02
xxhewkoxx: calls $0.01
Gambler HA has returned
tranemaster: checks 
*** FLOP *** [7h Kc 7d]
xxhewkoxx: bets $0.04
tranemaster: folds 
sapopez: calls $0.04
mariam73: folds 
rideraa: folds 
*** TURN *** [7h Kc 7d] [Js]
xxhewkoxx: bets $0.16
sapopez: folds 
Uncalled bet ($0.16) returned to xxhewkoxx
xxhewkoxx collected $0.18 from pot
*** SUMMARY ***
Total pot $0.18 | Rake $0 
Board [7h Kc 7d Js]
Seat 2: Philip Am folded before Flop (didn't bet)
Seat 3: ez.ronen folded before Flop (didn't bet)
Seat 4: mariam73 folded on the Flop
Seat 5: sunmt folded before Flop (didn't bet)
Seat 6: rideraa (button) folded on the Flop
Seat 7: xxhewkoxx (small blind) collected ($0.18)
Seat 8: tranemaster (big blind) folded on the Flop
Seat 9: sapopez folded on the Turn



PokerStars Game #24445789516:  Hold'em No Limit ($0.01/$0.02) - 2009/01/30 21:22:33 ET
Table 'Adalberta III' 9-max Seat #7 is the button
Seat 1: Gambler HA ($4.98 in chips) 
Seat 2: Philip Am ($1.29 in chips) 
Seat 3: ez.ronen ($2.16 in chips) 
Seat 4: mariam73 ($1.99 in chips) 
Seat 5: sunmt ($2 in chips) 
Seat 6: rideraa ($4.95 in chips) 
Seat 7: xxhewkoxx ($1.92 in chips) 
Seat 8: tranemaster ($3.58 in chips) 
Seat 9: sapopez ($3.19 in chips) 
tranemaster: posts small blind $0.01
sapopez: posts big blind $0.02
*** HOLE CARDS ***
Dealt to sunmt [Ac 8d]
Gambler HA: folds 
Philip Am: folds 
ez.ronen: folds 
mariam73: folds 
mariam73 leaves the table
sunmt: folds 
Vika76 joins the table at seat #4 
rideraa: folds 
xxhewkoxx: folds 
tranemaster: folds 
Uncalled bet ($0.01) returned to sapopez
sapopez collected $0.02 from pot
sapopez: doesn't show hand 
*** SUMMARY ***
Total pot $0.02 | Rake $0 
Seat 1: Gambler HA folded before Flop (didn't bet)
Seat 2: Philip Am folded before Flop (didn't bet)
Seat 3: ez.ronen folded before Flop (didn't bet)
Seat 4: mariam73 folded before Flop (didn't bet)
Seat 5: sunmt folded before Flop (didn't bet)
Seat 6: rideraa folded before Flop (didn't bet)
Seat 7: xxhewkoxx (button) folded before Flop (didn't bet)
Seat 8: tranemaster (small blind) folded before Flop
Seat 9: sapopez (big blind) collected ($0.02)



PokerStars Game #24445802181:  Hold'em No Limit ($0.01/$0.02) - 2009/01/30 21:23:00 ET
Table 'Adalberta III' 9-max Seat #8 is the button
Seat 1: Gambler HA ($4.98 in chips) 
Seat 2: Philip Am ($1.29 in chips) 
Seat 3: ez.ronen ($2.16 in chips) 
Seat 5: sunmt ($2 in chips) 
Seat 6: rideraa ($4.95 in chips) 
Seat 7: xxhewkoxx ($1.92 in chips) 
Seat 8: tranemaster ($3.57 in chips) 
Seat 9: sapopez ($3.20 in chips) 
sapopez: posts small blind $0.01
Gambler HA: posts big blind $0.02
Vika76: sits out 
*** HOLE CARDS ***
Dealt to sunmt [3d Ac]
Philip Am: folds 
ez.ronen: calls $0.02
sunmt: folds 
rideraa: folds 
xxhewkoxx: calls $0.02
tranemaster: folds 
sapopez: calls $0.01
Gambler HA: checks 
*** FLOP *** [2s 2h 9c]
sapopez: checks 
Gambler HA: bets $0.06
ez.ronen: folds 
xxhewkoxx: calls $0.06
sapopez: folds 
*** TURN *** [2s 2h 9c] [Kc]
Gambler HA: bets $0.06
xxhewkoxx: calls $0.06
*** RIVER *** [2s 2h 9c Kc] [5c]
Gambler HA: bets $0.06
xxhewkoxx: raises $0.06 to $0.12
Gambler HA: calls $0.06
*** SHOW DOWN ***
xxhewkoxx: shows [5h 9h] (two pair, Nines and Fives)
Gambler HA: mucks hand 
xxhewkoxx collected $0.56 from pot
*** SUMMARY ***
Total pot $0.56 | Rake $0 
Board [2s 2h 9c Kc 5c]
Seat 1: Gambler HA (big blind) mucked [9s 7d]
Seat 2: Philip Am folded before Flop (didn't bet)
Seat 3: ez.ronen folded on the Flop
Seat 5: sunmt folded before Flop (didn't bet)
Seat 6: rideraa folded before Flop (didn't bet)
Seat 7: xxhewkoxx showed [5h 9h] and won ($0.56) with two pair, Nines and Fives
Seat 8: tranemaster (button) folded before Flop (didn't bet)
Seat 9: sapopez (small blind) folded on the Flop



PokerStars Game #24445848524:  Hold'em No Limit ($0.01/$0.02) - 2009/01/30 21:24:40 ET
Table 'Adalberta III' 9-max Seat #9 is the button
Seat 1: Gambler HA ($4.72 in chips) 
Seat 2: Philip Am ($1.29 in chips) 
Seat 3: ez.ronen ($2.14 in chips) 
Seat 5: sunmt ($2 in chips) 
Seat 6: rideraa ($4.95 in chips) 
Seat 7: xxhewkoxx ($2.22 in chips) 
Seat 8: tranemaster ($3.57 in chips) 
Seat 9: sapopez ($3.18 in chips) 
Gambler HA: posts small blind $0.01
Philip Am: posts big blind $0.02
Vika76: sits out 
*** HOLE CARDS ***
Dealt to sunmt [3c 8s]
ez.ronen: calls $0.02
sunmt: folds 
rideraa: folds 
xxhewkoxx: raises $0.02 to $0.04
tranemaster: folds 
sapopez: raises $0.08 to $0.12
Gambler HA: folds 
Gambler HA is sitting out
Philip Am: folds 
ez.ronen: calls $0.10
xxhewkoxx: calls $0.08
*** FLOP *** [Jh Kc Js]
Gambler HA leaves the table
ez.ronen: checks 
xxhewkoxx: bets $0.08
sapopez: calls $0.08
ez.ronen: raises $0.08 to $0.16
xxhewkoxx: calls $0.08
sapopez: calls $0.08
*** TURN *** [Jh Kc Js] [5d]
ez.ronen: checks 
xxhewkoxx: bets $0.04
sapopez: calls $0.04
ez.ronen: calls $0.04
*** RIVER *** [Jh Kc Js 5d] [3d]
ez.ronen: checks 
xxhewkoxx: bets $0.08
sapopez: calls $0.08
ez.ronen: raises $0.24 to $0.32
xxhewkoxx: calls $0.24
sapopez: calls $0.24
*** SHOW DOWN ***
ez.ronen: shows [Jd Ks] (a full house, Jacks full of Kings)
xxhewkoxx: mucks hand 
sapopez: mucks hand 
ez.ronen collected $1.90 from pot
*** SUMMARY ***
Total pot $1.95 | Rake $0.05 
Board [Jh Kc Js 5d 3d]
Seat 1: Gambler HA (small blind) folded before Flop
Seat 2: Philip Am (big blind) folded before Flop
Seat 3: ez.ronen showed [Jd Ks] and won ($1.90) with a full house, Jacks full of Kings
Seat 5: sunmt folded before Flop (didn't bet)
Seat 6: rideraa folded before Flop (didn't bet)
Seat 7: xxhewkoxx mucked [Kh Ad]
Seat 8: tranemaster folded before Flop (didn't bet)
Seat 9: sapopez (button) mucked [Qc Ac]



PokerStars Game #24445896185:  Hold'em No Limit ($0.01/$0.02) - 2009/01/30 21:26:23 ET
Table 'Adalberta III' 9-max Seat #2 is the button
Seat 2: Philip Am ($1.27 in chips) 
Seat 3: ez.ronen ($3.40 in chips) 
Seat 4: Vika76 ($2 in chips) 
Seat 5: sunmt ($2 in chips) 
Seat 6: rideraa ($4.95 in chips) 
Seat 7: xxhewkoxx ($1.58 in chips) 
Seat 8: tranemaster ($3.57 in chips) 
Seat 9: sapopez ($2.54 in chips) 
ez.ronen: posts small blind $0.01
Vika76: posts big blind $0.02
*** HOLE CARDS ***
Dealt to sunmt [3c 9c]
sunmt: folds 
rideraa: folds 
xxhewkoxx: folds 
tranemaster: folds 
sapopez: folds 
Philip Am: folds 
ez.ronen: calls $0.01
Vika76: checks 
*** FLOP *** [Qh 5d Ts]
ez.ronen: checks 
Vika76: checks 
*** TURN *** [Qh 5d Ts] [Ah]
ez.ronen: checks 
Vika76: checks 
*** RIVER *** [Qh 5d Ts Ah] [2d]
ez.ronen: checks 
Vika76: checks 
*** SHOW DOWN ***
ez.ronen: shows [Kd 4d] (high card Ace)
Vika76: mucks hand 
ez.ronen collected $0.04 from pot
*** SUMMARY ***
Total pot $0.04 | Rake $0 
Board [Qh 5d Ts Ah 2d]
Seat 2: Philip Am (button) folded before Flop (didn't bet)
Seat 3: ez.ronen (small blind) showed [Kd 4d] and won ($0.04) with high card Ace
Seat 4: Vika76 (big blind) mucked [7d 6c]
Seat 5: sunmt folded before Flop (didn't bet)
Seat 6: rideraa folded before Flop (didn't bet)
Seat 7: xxhewkoxx folded before Flop (didn't bet)
Seat 8: tranemaster folded before Flop (didn't bet)
Seat 9: sapopez folded before Flop (didn't bet)



PokerStars Game #24445923740:  Hold'em No Limit ($0.01/$0.02) - 2009/01/30 21:27:20 ET
Table 'Adalberta III' 9-max Seat #3 is the button
Seat 2: Philip Am ($1.27 in chips) 
Seat 3: ez.ronen ($3.42 in chips) 
Seat 4: Vika76 ($2 in chips) 
Seat 5: sunmt ($2 in chips) 
Seat 6: rideraa ($4.95 in chips) 
Seat 7: xxhewkoxx ($1.58 in chips) 
Seat 8: tranemaster ($3.57 in chips) 
Seat 9: sapopez ($2.54 in chips) 
Vika76: posts small blind $0.01
sunmt: posts big blind $0.02
*** HOLE CARDS ***
Dealt to sunmt [Ks Jh]
rideraa: folds 
xxhewkoxx: calls $0.02
tranemaster: folds 
sapopez: folds 
Philip Am: raises $0.08 to $0.10
ez.ronen: folds 
Vika76: folds 
sunmt: folds 
xxhewkoxx: folds 
Uncalled bet ($0.08) returned to Philip Am
Philip Am collected $0.07 from pot
Philip Am: doesn't show hand 
*** SUMMARY ***
Total pot $0.07 | Rake $0 
Seat 2: Philip Am collected ($0.07)
Seat 3: ez.ronen (button) folded before Flop (didn't bet)
Seat 4: Vika76 (small blind) folded before Flop
Seat 5: sunmt (big blind) folded before Flop
Seat 6: rideraa folded before Flop (didn't bet)
Seat 7: xxhewkoxx folded before Flop
Seat 8: tranemaster folded before Flop (didn't bet)
Seat 9: sapopez folded before Flop (didn't bet)



PokerStars Game #24445943583:  Hold'em No Limit ($0.01/$0.02) - 2009/01/30 21:28:02 ET
Table 'Adalberta III' 9-max Seat #4 is the button
Seat 2: Philip Am ($1.32 in chips) 
Seat 3: ez.ronen ($3.42 in chips) 
Seat 4: Vika76 ($2 in chips) 
Seat 5: sunmt ($1.98 in chips) 
Seat 6: rideraa ($4.95 in chips) 
Seat 7: xxhewkoxx ($1.56 in chips) 
Seat 8: tranemaster ($3.57 in chips) 
Seat 9: sapopez ($2.54 in chips) 
sunmt: posts small blind $0.01
rideraa: posts big blind $0.02
*** HOLE CARDS ***
Dealt to sunmt [3s 7h]
xxhewkoxx: calls $0.02
tranemaster: folds 
sapopez: folds 
Philip Am: folds 
ez.ronen: folds 
Vika76: folds 
sunmt: folds 
rideraa: checks 
*** FLOP *** [Ks 2s 8s]
rideraa: checks 
xxhewkoxx: checks 
*** TURN *** [Ks 2s 8s] [9c]
rideraa: checks 
xxhewkoxx: checks 
*** RIVER *** [Ks 2s 8s 9c] [5c]
rideraa: checks 
xxhewkoxx: checks 
*** SHOW DOWN ***
rideraa: shows [Th Tc] (a pair of Tens)
xxhewkoxx: mucks hand 
rideraa collected $0.05 from pot
*** SUMMARY ***
Total pot $0.05 | Rake $0 
Board [Ks 2s 8s 9c 5c]
Seat 2: Philip Am folded before Flop (didn't bet)
Seat 3: ez.ronen folded before Flop (didn't bet)
Seat 4: Vika76 (button) folded before Flop (didn't bet)
Seat 5: sunmt (small blind) folded before Flop
Seat 6: rideraa (big blind) showed [Th Tc] and won ($0.05) with a pair of Tens
Seat 7: xxhewkoxx mucked [Td Qh]
Seat 8: tranemaster folded before Flop (didn't bet)
Seat 9: sapopez folded before Flop (didn't bet)



PokerStars Game #24445981679:  Hold'em No Limit ($0.01/$0.02) - 2009/01/30 21:29:24 ET
Table 'Adalberta III' 9-max Seat #5 is the button
Seat 2: Philip Am ($1.32 in chips) 
Seat 3: ez.ronen ($3.42 in chips) 
Seat 4: Vika76 ($2 in chips) 
Seat 5: sunmt ($1.97 in chips) 
Seat 6: rideraa ($4.98 in chips) 
Seat 7: xxhewkoxx ($1.54 in chips) 
Seat 8: tranemaster ($3.57 in chips) 
Seat 9: sapopez ($2.54 in chips) 
rideraa: posts small blind $0.01
xxhewkoxx: posts big blind $0.02
*** HOLE CARDS ***
Dealt to sunmt [2d 5c]
tranemaster: folds 
sapopez: folds 
Philip Am: folds 
ez.ronen: folds 
Vika76: folds 
sunmt: folds 
rideraa: folds 
Uncalled bet ($0.01) returned to xxhewkoxx
xxhewkoxx collected $0.02 from pot
*** SUMMARY ***
Total pot $0.02 | Rake $0 
Seat 2: Philip Am folded before Flop (didn't bet)
Seat 3: ez.ronen folded before Flop (didn't bet)
Seat 4: Vika76 folded before Flop (didn't bet)
Seat 5: sunmt (button) folded before Flop (didn't bet)
Seat 6: rideraa (small blind) folded before Flop
Seat 7: xxhewkoxx (big blind) collected ($0.02)
Seat 8: tranemaster folded before Flop (didn't bet)
Seat 9: sapopez folded before Flop (didn't bet)



PokerStars Game #24445997489:  Hold'em No Limit ($0.01/$0.02) - 2009/01/30 21:29:58 ET
Table 'Adalberta III' 9-max Seat #6 is the button
Seat 2: Philip Am ($1.32 in chips) 
Seat 3: ez.ronen ($3.42 in chips) 
Seat 4: Vika76 ($2 in chips) 
Seat 5: sunmt ($1.97 in chips) 
Seat 6: rideraa ($4.97 in chips) 
Seat 7: xxhewkoxx ($1.55 in chips) 
Seat 8: tranemaster ($3.57 in chips) 
Seat 9: sapopez ($2.54 in chips) 
xxhewkoxx: posts small blind $0.01
tranemaster: posts big blind $0.02
*** HOLE CARDS ***
Dealt to sunmt [7d 8d]
sapopez: folds 
Philip Am: folds 
ez.ronen: folds 
Vika76: calls $0.02
sunmt: raises $0.04 to $0.06
rideraa: calls $0.06
xxhewkoxx: calls $0.05
tranemaster: folds 
Vika76: calls $0.04
*** FLOP *** [Ah Ts 3c]
xxhewkoxx: bets $0.04
Vika76: folds 
sunmt: folds 
rideraa: calls $0.04
*** TURN *** [Ah Ts 3c] [2c]
xxhewkoxx: bets $0.08
rideraa: raises $0.08 to $0.16
xxhewkoxx: calls $0.08
*** RIVER *** [Ah Ts 3c 2c] [7h]
xxhewkoxx: checks 
rideraa: checks 
*** SHOW DOWN ***
xxhewkoxx: shows [Qh Jh] (high card Ace)
rideraa: shows [As Kc] (a pair of Aces)
xxhewkoxx is sitting out
rideraa collected $0.66 from pot
*** SUMMARY ***
Total pot $0.66 | Rake $0 
Board [Ah Ts 3c 2c 7h]
Seat 2: Philip Am folded before Flop (didn't bet)
Seat 3: ez.ronen folded before Flop (didn't bet)
Seat 4: Vika76 folded on the Flop
Seat 5: sunmt folded on the Flop
Seat 6: rideraa (button) showed [As Kc] and won ($0.66) with a pair of Aces
Seat 7: xxhewkoxx (small blind) showed [Qh Jh] and lost with high card Ace
Seat 8: tranemaster (big blind) folded before Flop
Seat 9: sapopez folded before Flop (didn't bet)



PokerStars Game #24446033692:  Hold'em No Limit ($0.01/$0.02) - 2009/01/30 21:31:15 ET
Table 'Adalberta III' 9-max Seat #8 is the button
Seat 2: Philip Am ($1.32 in chips) 
Seat 3: ez.ronen ($3.42 in chips) 
Seat 4: Vika76 ($2 in chips) 
Seat 5: sunmt ($1.91 in chips) 
Seat 6: rideraa ($5.37 in chips) 
Seat 8: tranemaster ($3.55 in chips) 
Seat 9: sapopez ($2.54 in chips) 
sapopez: posts small blind $0.01
Philip Am: posts big blind $0.02
*** HOLE CARDS ***
Dealt to sunmt [Ac 7s]
ez.ronen: calls $0.02
xxhewkoxx leaves the table
Vika76: folds 
sunmt: folds 
rideraa: folds 
tranemaster: folds 
sapopez: calls $0.01
Philip Am: checks 
*** FLOP *** [2c 5c 7h]
sapopez: checks 
Philip Am: checks 
ez.ronen: bets $0.02
sapopez: calls $0.02
Philip Am: folds 
*** TURN *** [2c 5c 7h] [Ts]
sapopez: checks 
ez.ronen: bets $0.02
sapopez: calls $0.02
*** RIVER *** [2c 5c 7h Ts] [Js]
sapopez: checks 
ez.ronen: checks 
*** SHOW DOWN ***
sapopez: shows [4d 5s] (a pair of Fives)
ez.ronen: shows [Ad 7d] (a pair of Sevens)
ez.ronen collected $0.14 from pot
*** SUMMARY ***
Total pot $0.14 | Rake $0 
Board [2c 5c 7h Ts Js]
Seat 2: Philip Am (big blind) folded on the Flop
Seat 3: ez.ronen showed [Ad 7d] and won ($0.14) with a pair of Sevens
Seat 4: Vika76 folded before Flop (didn't bet)
Seat 5: sunmt folded before Flop (didn't bet)
Seat 6: rideraa folded before Flop (didn't bet)
Seat 8: tranemaster (button) folded before Flop (didn't bet)
Seat 9: sapopez (small blind) showed [4d 5s] and lost with a pair of Fives



PokerStars Game #24446067582:  Hold'em No Limit ($0.01/$0.02) - 2009/01/30 21:32:28 ET
Table 'Adalberta III' 9-max Seat #9 is the button
Seat 2: Philip Am ($1.30 in chips) 
Seat 3: ez.ronen ($3.50 in chips) 
Seat 4: Vika76 ($2 in chips) 
Seat 5: sunmt ($1.91 in chips) 
Seat 6: rideraa ($5.37 in chips) 
Seat 8: tranemaster ($3.55 in chips) 
Seat 9: sapopez ($2.48 in chips) 
Philip Am: posts small blind $0.01
ez.ronen: posts big blind $0.02
*** HOLE CARDS ***
Dealt to sunmt [6h 6c]
Vika76: folds 
sunmt: raises $0.04 to $0.06
rideraa: folds 
tranemaster: calls $0.06
sapopez: folds 
Philip Am: folds 
ez.ronen: calls $0.04
*** FLOP *** [Qc 2c Th]
ez.ronen: checks 
sunmt: checks 
tranemaster: checks 
*** TURN *** [Qc 2c Th] [3h]
ez.ronen: checks 
sunmt: checks 
tranemaster: checks 
*** RIVER *** [Qc 2c Th 3h] [9c]
ez.ronen: checks 
sunmt: checks 
tranemaster: checks 
*** SHOW DOWN ***
ez.ronen: shows [6d 8d] (high card Queen)
sunmt: shows [6h 6c] (a pair of Sixes)
tranemaster: mucks hand 
sunmt collected $0.19 from pot
*** SUMMARY ***
Total pot $0.19 | Rake $0 
Board [Qc 2c Th 3h 9c]
Seat 2: Philip Am (small blind) folded before Flop
Seat 3: ez.ronen (big blind) showed [6d 8d] and lost with high card Queen
Seat 4: Vika76 folded before Flop (didn't bet)
Seat 5: sunmt showed [6h 6c] and won ($0.19) with a pair of Sixes
Seat 6: rideraa folded before Flop (didn't bet)
Seat 8: tranemaster mucked [4s 4h]
Seat 9: sapopez (button) folded before Flop (didn't bet)



PokerStars Game #24446107454:  Hold'em No Limit ($0.01/$0.02) - 2009/01/30 21:33:54 ET
Table 'Adalberta III' 9-max Seat #2 is the button
Seat 2: Philip Am ($1.29 in chips) 
Seat 3: ez.ronen ($3.44 in chips) 
Seat 4: Vika76 ($2 in chips) 
Seat 5: sunmt ($2.04 in chips) 
Seat 6: rideraa ($5.37 in chips) 
Seat 8: tranemaster ($3.49 in chips) 
Seat 9: sapopez ($2.48 in chips) 
ez.ronen: posts small blind $0.01
Vika76: posts big blind $0.02
*** HOLE CARDS ***
Dealt to sunmt [Ad Kh]
sunmt: raises $0.06 to $0.08
rideraa: folds 
tranemaster: folds 
sapopez: folds 
Philip Am: folds 
ez.ronen: folds 
Vika76: folds 
Uncalled bet ($0.06) returned to sunmt
sunmt collected $0.05 from pot
sunmt: doesn't show hand 
*** SUMMARY ***
Total pot $0.05 | Rake $0 
Seat 2: Philip Am (button) folded before Flop (didn't bet)
Seat 3: ez.ronen (small blind) folded before Flop
Seat 4: Vika76 (big blind) folded before Flop
Seat 5: sunmt collected ($0.05)
Seat 6: rideraa folded before Flop (didn't bet)
Seat 8: tranemaster folded before Flop (didn't bet)
Seat 9: sapopez folded before Flop (didn't bet)



PokerStars Game #24446128594:  Hold'em No Limit ($0.01/$0.02) - 2009/01/30 21:34:40 ET
Table 'Adalberta III' 9-max Seat #3 is the button
Seat 2: Philip Am ($1.29 in chips) 
Seat 3: ez.ronen ($3.43 in chips) 
Seat 4: Vika76 ($2 in chips) 
Seat 5: sunmt ($2.07 in chips) 
Seat 6: rideraa ($5.37 in chips) 
Seat 8: tranemaster ($3.49 in chips) 
Seat 9: sapopez ($2.48 in chips) 
Vika76: posts small blind $0.01
sunmt: posts big blind $0.02
*** HOLE CARDS ***
Dealt to sunmt [6s Ts]
rideraa: folds 
tranemaster: folds 
sapopez: folds 
Philip Am: folds 
ez.ronen: folds 
Vika76: calls $0.01
sunmt: checks 
*** FLOP *** [4s 8d 3s]
Vika76: checks 
sunmt: checks 
*** TURN *** [4s 8d 3s] [Js]
Vika76: checks 
sunmt: bets $0.04
Vika76: folds 
Uncalled bet ($0.04) returned to sunmt
sunmt collected $0.04 from pot
sunmt: doesn't show hand 
*** SUMMARY ***
Total pot $0.04 | Rake $0 
Board [4s 8d 3s Js]
Seat 2: Philip Am folded before Flop (didn't bet)
Seat 3: ez.ronen (button) folded before Flop (didn't bet)
Seat 4: Vika76 (small blind) folded on the Turn
Seat 5: sunmt (big blind) collected ($0.04)
Seat 6: rideraa folded before Flop (didn't bet)
Seat 8: tranemaster folded before Flop (didn't bet)
Seat 9: sapopez folded before Flop (didn't bet)



PokerStars Game #24446154505:  Hold'em No Limit ($0.01/$0.02) - 2009/01/30 21:35:36 ET
Table 'Adalberta III' 9-max Seat #4 is the button
Seat 2: Philip Am ($1.29 in chips) 
Seat 3: ez.ronen ($3.43 in chips) 
Seat 4: Vika76 ($2 in chips) 
Seat 5: sunmt ($2.09 in chips) 
Seat 6: rideraa ($5.37 in chips) 
Seat 8: tranemaster ($3.49 in chips) 
Seat 9: sapopez ($2.48 in chips) 
sunmt: posts small blind $0.01
rideraa: posts big blind $0.02
*** HOLE CARDS ***
Dealt to sunmt [3d 2d]
rebelchick05 joins the table at seat #1 
tranemaster: folds 
sapopez: folds 
Philip Am: folds 
ez.ronen: calls $0.02
Vika76: calls $0.02
sunmt: calls $0.01
rideraa: checks 
*** FLOP *** [9h 7d 8d]
sunmt: bets $0.06
rideraa: folds 
ez.ronen: calls $0.06
Vika76: calls $0.06
*** TURN *** [9h 7d 8d] [Qc]
sunmt: checks 
ez.ronen: checks 
Vika76: checks 
*** RIVER *** [9h 7d 8d Qc] [Qs]
sunmt: checks 
ez.ronen: bets $0.02
Vika76: calls $0.02
sunmt: folds 
*** SHOW DOWN ***
ez.ronen: shows [7h Kh] (two pair, Queens and Sevens)
Vika76: shows [9c Ac] (two pair, Queens and Nines)
Vika76 collected $0.30 from pot
*** SUMMARY ***
Total pot $0.30 | Rake $0 
Board [9h 7d 8d Qc Qs]
Seat 2: Philip Am folded before Flop (didn't bet)
Seat 3: ez.ronen showed [7h Kh] and lost with two pair, Queens and Sevens
Seat 4: Vika76 (button) showed [9c Ac] and won ($0.30) with two pair, Queens and Nines
Seat 5: sunmt (small blind) folded on the River
Seat 6: rideraa (big blind) folded on the Flop
Seat 8: tranemaster folded before Flop (didn't bet)
Seat 9: sapopez folded before Flop (didn't bet)



PokerStars Game #24446190205:  Hold'em No Limit ($0.01/$0.02) - 2009/01/30 21:36:55 ET
Table 'Adalberta III' 9-max Seat #5 is the button
Seat 2: Philip Am ($1.29 in chips) 
Seat 3: ez.ronen ($3.33 in chips) 
Seat 4: Vika76 ($2.20 in chips) 
Seat 5: sunmt ($2.01 in chips) 
Seat 6: rideraa ($5.35 in chips) 
Seat 8: tranemaster ($3.49 in chips) 
Seat 9: sapopez ($2.48 in chips) 
rideraa: posts small blind $0.01
tranemaster: posts big blind $0.02
rebelchick05: sits out 
*** HOLE CARDS ***
Dealt to sunmt [Kh Jc]
sapopez: folds 
Philip Am: folds 
ez.ronen: calls $0.02
Vika76: folds 
sunmt: raises $0.04 to $0.06
rideraa: folds 
tranemaster: folds 
ez.ronen: calls $0.04
*** FLOP *** [Kd 3h Qc]
ez.ronen: checks 
sunmt: bets $0.08
ez.ronen: folds 
Uncalled bet ($0.08) returned to sunmt
sunmt collected $0.15 from pot
sunmt: doesn't show hand 
*** SUMMARY ***
Total pot $0.15 | Rake $0 
Board [Kd 3h Qc]
Seat 2: Philip Am folded before Flop (didn't bet)
Seat 3: ez.ronen folded on the Flop
Seat 4: Vika76 folded before Flop (didn't bet)
Seat 5: sunmt (button) collected ($0.15)
Seat 6: rideraa (small blind) folded before Flop
Seat 8: tranemaster (big blind) folded before Flop
Seat 9: sapopez folded before Flop (didn't bet)



PokerStars Game #24446216570:  Hold'em No Limit ($0.01/$0.02) - 2009/01/30 21:37:52 ET
Table 'Adalberta III' 9-max Seat #6 is the button
Seat 2: Philip Am ($1.29 in chips) 
Seat 3: ez.ronen ($3.27 in chips) 
Seat 4: Vika76 ($2.20 in chips) 
Seat 5: sunmt ($2.10 in chips) 
Seat 6: rideraa ($5.34 in chips) 
Seat 8: tranemaster ($3.47 in chips) 
Seat 9: sapopez ($2.48 in chips) 
tranemaster: posts small blind $0.01
sapopez: posts big blind $0.02
rebelchick05: sits out 
*** HOLE CARDS ***
Dealt to sunmt [Tc 2s]
Philip Am: folds 
ez.ronen: folds 
Vika76: calls $0.02
sunmt: folds 
rideraa: folds 
tranemaster: folds 
sapopez: checks 
*** FLOP *** [6h Td 9h]
sapopez: checks 
Vika76: checks 
*** TURN *** [6h Td 9h] [2h]
sapopez: checks 
Vika76: bets $0.04
sapopez: folds 
Uncalled bet ($0.04) returned to Vika76
Vika76 collected $0.05 from pot
Vika76: doesn't show hand 
*** SUMMARY ***
Total pot $0.05 | Rake $0 
Board [6h Td 9h 2h]
Seat 2: Philip Am folded before Flop (didn't bet)
Seat 3: ez.ronen folded before Flop (didn't bet)
Seat 4: Vika76 collected ($0.05)
Seat 5: sunmt folded before Flop (didn't bet)
Seat 6: rideraa (button) folded before Flop (didn't bet)
Seat 8: tranemaster (small blind) folded before Flop
Seat 9: sapopez (big blind) folded on the Turn



PokerStars Game #24446250173:  Hold'em No Limit ($0.01/$0.02) - 2009/01/30 21:39:05 ET
Table 'Adalberta III' 9-max Seat #8 is the button
Seat 1: rebelchick05 ($2.29 in chips) 
Seat 2: Philip Am ($1.29 in chips) 
Seat 3: ez.ronen ($3.27 in chips) 
Seat 4: Vika76 ($2.23 in chips) 
Seat 5: sunmt ($2.10 in chips) 
Seat 6: rideraa ($5.34 in chips) 
Seat 8: tranemaster ($3.46 in chips) 
Seat 9: sapopez ($2.46 in chips) 
sapopez: posts small blind $0.01
rebelchick05: posts big blind $0.02
*** HOLE CARDS ***
Dealt to sunmt [2c 5d]
Philip Am: folds 
ez.ronen: folds 
Philip Am is sitting out
Vika76: calls $0.02
sunmt: folds 
rideraa: calls $0.02
tranemaster: folds 
sapopez: calls $0.01
rebelchick05: checks 
*** FLOP *** [Qc Js 2h]
sapopez: checks 
rebelchick05: checks 
Vika76: bets $0.06
rideraa: folds 
rebelchick05 said, "why does anyone want to play more tables than they can keep up with ??"
sapopez: folds 
rebelchick05: folds 
Uncalled bet ($0.06) returned to Vika76
Vika76 collected $0.08 from pot
Vika76: doesn't show hand 
*** SUMMARY ***
Total pot $0.08 | Rake $0 
Board [Qc Js 2h]
Seat 1: rebelchick05 (big blind) folded on the Flop
Seat 2: Philip Am folded before Flop (didn't bet)
Seat 3: ez.ronen folded before Flop (didn't bet)
Seat 4: Vika76 collected ($0.08)
Seat 5: sunmt folded before Flop (didn't bet)
Seat 6: rideraa folded on the Flop
Seat 8: tranemaster (button) folded before Flop (didn't bet)
Seat 9: sapopez (small blind) folded on the Flop



PokerStars Game #24446285318:  Hold'em No Limit ($0.01/$0.02) - 2009/01/30 21:40:21 ET
Table 'Adalberta III' 9-max Seat #9 is the button
Seat 1: rebelchick05 ($2.27 in chips) 
Seat 3: ez.ronen ($3.27 in chips) 
Seat 4: Vika76 ($2.29 in chips) 
Seat 5: sunmt ($2.10 in chips) 
Seat 6: rideraa ($5.32 in chips) 
Seat 8: tranemaster ($3.46 in chips) 
Seat 9: sapopez ($2.44 in chips) 
rebelchick05: posts small blind $0.01
Feloniously1 joins the table at seat #7 
ez.ronen: posts big blind $0.02
*** HOLE CARDS ***
Dealt to sunmt [7d 7s]
Philip Am leaves the table
Vika76: calls $0.02
ku12 joins the table at seat #2 
sunmt: raises $0.04 to $0.06
rideraa: calls $0.06
tranemaster: calls $0.06
sapopez: folds 
rebelchick05: folds 
ez.ronen: folds 
Vika76: calls $0.04
*** FLOP *** [8h 6h 9h]
ez.ronen leaves the table
Vika76: checks 
sunmt: checks 
rideraa: checks 
tranemaster: checks 
*** TURN *** [8h 6h 9h] [7c]
Vika76: checks 
sunmt: bets $0.30
rebelchick05 leaves the table
rideraa: folds 
tranemaster: folds 
Vika76: folds 
Uncalled bet ($0.30) returned to sunmt
sunmt collected $0.27 from pot
sunmt: doesn't show hand 
*** SUMMARY ***
Total pot $0.27 | Rake $0 
Board [8h 6h 9h 7c]
Seat 1: rebelchick05 (small blind) folded before Flop
Seat 3: ez.ronen (big blind) folded before Flop
Seat 4: Vika76 folded on the Turn
Seat 5: sunmt collected ($0.27)
Seat 6: rideraa folded on the Turn
Seat 8: tranemaster folded on the Turn
Seat 9: sapopez (button) folded before Flop (didn't bet)



PokerStars Game #24446351592:  Hold'em No Limit ($0.01/$0.02) - 2009/01/30 21:42:45 ET
Table 'Adalberta III' 9-max Seat #4 is the button
Seat 4: Vika76 ($2.23 in chips) 
Seat 5: sunmt ($2.31 in chips) 
Seat 6: rideraa ($5.26 in chips) 
Seat 7: Feloniously1 ($3 in chips) 
Seat 8: tranemaster ($3.40 in chips) 
Seat 9: sapopez ($2.44 in chips) 
sunmt: posts small blind $0.01
rideraa: posts big blind $0.02
Feloniously1: posts big blind $0.02
ku12: sits out 
*** HOLE CARDS ***
Dealt to sunmt [3h 5c]
Feloniously1: checks 
tranemaster: folds 
bandit707 joins the table at seat #3 
sapopez: folds 
Vika76: calls $0.02
sunmt: folds 
rideraa: checks 
*** FLOP *** [7c Qc Td]
rideraa: bets $0.16
Feloniously1: calls $0.16
Vika76: folds 
*** TURN *** [7c Qc Td] [6h]
bandit707 is sitting out
rideraa: bets $0.50
Feloniously1: folds 
Uncalled bet ($0.50) returned to rideraa
rideraa collected $0.39 from pot
*** SUMMARY ***
Total pot $0.39 | Rake $0 
Board [7c Qc Td 6h]
Seat 4: Vika76 (button) folded on the Flop
Seat 5: sunmt (small blind) folded before Flop
Seat 6: rideraa (big blind) collected ($0.39)
Seat 7: Feloniously1 folded on the Turn
Seat 8: tranemaster folded before Flop (didn't bet)
Seat 9: sapopez folded before Flop (didn't bet)



PokerStars Game #24446401513:  Hold'em No Limit ($0.01/$0.02) - 2009/01/30 21:44:35 ET
Table 'Adalberta III' 9-max Seat #5 is the button
Seat 4: Vika76 ($2.21 in chips) 
Seat 5: sunmt ($2.30 in chips) 
Seat 6: rideraa ($5.47 in chips) 
Seat 7: Feloniously1 ($2.82 in chips) 
Seat 8: tranemaster ($3.40 in chips) 
Seat 9: sapopez ($2.44 in chips) 
rideraa: posts small blind $0.01
Feloniously1: posts big blind $0.02
ku12: sits out 
*** HOLE CARDS ***
Dealt to sunmt [As Ad]
tranemaster: calls $0.02
sapopez: folds 
Vika76: calls $0.02
bandit707 has returned
sunmt: raises $0.28 to $0.30
rideraa: folds 
Feloniously1: folds 
tranemaster: folds 
epigmenio77 joins the table at seat #1 
Vika76: folds 
Uncalled bet ($0.28) returned to sunmt
sunmt collected $0.09 from pot
sunmt: doesn't show hand 
*** SUMMARY ***
Total pot $0.09 | Rake $0 
Seat 4: Vika76 folded before Flop
Seat 5: sunmt (button) collected ($0.09)
Seat 6: rideraa (small blind) folded before Flop
Seat 7: Feloniously1 (big blind) folded before Flop
Seat 8: tranemaster folded before Flop
Seat 9: sapopez folded before Flop (didn't bet)



PokerStars Game #24446434448:  Hold'em No Limit ($0.01/$0.02) - 2009/01/30 21:45:48 ET
Table 'Adalberta III' 9-max Seat #6 is the button
Seat 1: epigmenio77 ($1.80 in chips) 
Seat 3: bandit707 ($1 in chips) 
Seat 4: Vika76 ($2.19 in chips) 
Seat 5: sunmt ($2.37 in chips) 
Seat 6: rideraa ($5.46 in chips) 
Seat 7: Feloniously1 ($2.80 in chips) 
Seat 8: tranemaster ($3.38 in chips) 
Seat 9: sapopez ($2.44 in chips) 
Feloniously1: posts small blind $0.01
tranemaster: posts big blind $0.02
epigmenio77: posts big blind $0.02
ku12: sits out 
bandit707: posts big blind $0.02
*** HOLE CARDS ***
Dealt to sunmt [Jc 4c]
sapopez: folds 
epigmenio77: checks 
bandit707: checks 
Vika76: folds 
sunmt: folds 
rideraa: folds 
Feloniously1: calls $0.01
tranemaster: checks 
*** FLOP *** [5d 4d 6d]
Feloniously1: checks 
tranemaster: checks 
epigmenio77: bets $0.05
bandit707: folds 
Feloniously1: calls $0.05
tranemaster: folds 
*** TURN *** [5d 4d 6d] [Jd]
Feloniously1: checks 
epigmenio77: checks 
*** RIVER *** [5d 4d 6d Jd] [Js]
Feloniously1: checks 
epigmenio77: checks 
*** SHOW DOWN ***
Feloniously1: shows [7h Ah] (a pair of Jacks)
epigmenio77: shows [6c 4h] (two pair, Jacks and Sixes)
epigmenio77 collected $0.18 from pot
*** SUMMARY ***
Total pot $0.18 | Rake $0 
Board [5d 4d 6d Jd Js]
Seat 1: epigmenio77 showed [6c 4h] and won ($0.18) with two pair, Jacks and Sixes
Seat 3: bandit707 folded on the Flop
Seat 4: Vika76 folded before Flop (didn't bet)
Seat 5: sunmt folded before Flop (didn't bet)
Seat 6: rideraa (button) folded before Flop (didn't bet)
Seat 7: Feloniously1 (small blind) showed [7h Ah] and lost with a pair of Jacks
Seat 8: tranemaster (big blind) folded on the Flop
Seat 9: sapopez folded before Flop (didn't bet)



PokerStars Game #24446476055:  Hold'em No Limit ($0.01/$0.02) - 2009/01/30 21:47:19 ET
Table 'Adalberta III' 9-max Seat #7 is the button
Seat 1: epigmenio77 ($1.91 in chips) 
Seat 3: bandit707 ($0.98 in chips) 
Seat 4: Vika76 ($2.19 in chips) 
Seat 5: sunmt ($2.37 in chips) 
Seat 6: rideraa ($5.46 in chips) 
Seat 7: Feloniously1 ($2.73 in chips) 
Seat 8: tranemaster ($3.36 in chips) 
Seat 9: sapopez ($2.44 in chips) 
tranemaster: posts small blind $0.01
sapopez: posts big blind $0.02
ku12: sits out 
*** HOLE CARDS ***
Dealt to sunmt [2h Kd]
epigmenio77: raises $0.04 to $0.06
bandit707: folds 
Vika76: folds 
sunmt: folds 
rideraa: folds 
Feloniously1: calls $0.06
tranemaster: calls $0.05
sapopez: folds 
*** FLOP *** [8h 4h 5s]
tranemaster: checks 
epigmenio77: checks 
Feloniously1: checks 
*** TURN *** [8h 4h 5s] [4d]
tranemaster: checks 
epigmenio77: bets $0.12
Feloniously1: calls $0.12
tranemaster: raises $0.30 to $0.42
epigmenio77: folds 
Feloniously1: folds 
Uncalled bet ($0.30) returned to tranemaster
tranemaster collected $0.56 from pot
tranemaster: doesn't show hand 
*** SUMMARY ***
Total pot $0.56 | Rake $0 
Board [8h 4h 5s 4d]
Seat 1: epigmenio77 folded on the Turn
Seat 3: bandit707 folded before Flop (didn't bet)
Seat 4: Vika76 folded before Flop (didn't bet)
Seat 5: sunmt folded before Flop (didn't bet)
Seat 6: rideraa folded before Flop (didn't bet)
Seat 7: Feloniously1 (button) folded on the Turn
Seat 8: tranemaster (small blind) collected ($0.56)
Seat 9: sapopez (big blind) folded before Flop



PokerStars Game #24446515310:  Hold'em No Limit ($0.01/$0.02) - 2009/01/30 21:48:45 ET
Table 'Adalberta III' 9-max Seat #8 is the button
Seat 1: epigmenio77 ($1.73 in chips) 
Seat 3: bandit707 ($0.98 in chips) 
Seat 4: Vika76 ($2.19 in chips) 
Seat 5: sunmt ($2.37 in chips) 
Seat 6: rideraa ($5.46 in chips) 
Seat 7: Feloniously1 ($2.55 in chips) 
Seat 8: tranemaster ($3.74 in chips) 
Seat 9: sapopez ($2.42 in chips) 
sapopez: posts small blind $0.01
epigmenio77: posts big blind $0.02
ku12: sits out 
*** HOLE CARDS ***
Dealt to sunmt [Jc 5h]
bandit707: folds 
Vika76: folds 
sunmt: folds 
rideraa: folds 
Feloniously1: folds 
tranemaster: folds 
sapopez: folds 
Uncalled bet ($0.01) returned to epigmenio77
epigmenio77 collected $0.02 from pot
epigmenio77: doesn't show hand 
*** SUMMARY ***
Total pot $0.02 | Rake $0 
Seat 1: epigmenio77 (big blind) collected ($0.02)
Seat 3: bandit707 folded before Flop (didn't bet)
Seat 4: Vika76 folded before Flop (didn't bet)
Seat 5: sunmt folded before Flop (didn't bet)
Seat 6: rideraa folded before Flop (didn't bet)
Seat 7: Feloniously1 folded before Flop (didn't bet)
Seat 8: tranemaster (button) folded before Flop (didn't bet)
Seat 9: sapopez (small blind) folded before Flop



PokerStars Game #24446548018:  Hold'em No Limit ($0.01/$0.02) - 2009/01/30 21:49:56 ET
Table 'Adalberta III' 9-max Seat #9 is the button
Seat 1: epigmenio77 ($1.74 in chips) 
Seat 2: ku12 ($3 in chips) 
Seat 3: bandit707 ($0.98 in chips) 
Seat 4: Vika76 ($2.19 in chips) 
Seat 5: sunmt ($2.37 in chips) 
Seat 6: rideraa ($5.46 in chips) 
Seat 7: Feloniously1 ($2.55 in chips) 
Seat 8: tranemaster ($3.74 in chips) 
Seat 9: sapopez ($2.41 in chips) 
epigmenio77: posts small blind $0.01
ku12: posts big blind $0.02
*** HOLE CARDS ***
Dealt to sunmt [8d 6s]
bandit707: calls $0.02
Vika76: folds 
sunmt: folds 
rideraa: calls $0.02
Feloniously1: raises $0.08 to $0.10
tranemaster: folds 
sapopez: folds 
epigmenio77: folds 
ku12: folds 
bandit707: folds 
rideraa: calls $0.08
*** FLOP *** [Jc 7h 4d]
rideraa: checks 
Feloniously1: bets $2.45 and is all-in
rideraa: folds 
Uncalled bet ($2.45) returned to Feloniously1
Feloniously1 collected $0.25 from pot
*** SUMMARY ***
Total pot $0.25 | Rake $0 
Board [Jc 7h 4d]
Seat 1: epigmenio77 (small blind) folded before Flop
Seat 2: ku12 (big blind) folded before Flop
Seat 3: bandit707 folded before Flop
Seat 4: Vika76 folded before Flop (didn't bet)
Seat 5: sunmt folded before Flop (didn't bet)
Seat 6: rideraa folded on the Flop
Seat 7: Feloniously1 collected ($0.25)
Seat 8: tranemaster folded before Flop (didn't bet)
Seat 9: sapopez (button) folded before Flop (didn't bet)



PokerStars Game #24446586635:  Hold'em No Limit ($0.01/$0.02) - 2009/01/30 21:51:20 ET
Table 'Adalberta III' 9-max Seat #1 is the button
Seat 1: epigmenio77 ($1.73 in chips) 
Seat 2: ku12 ($2.98 in chips) 
Seat 3: bandit707 ($0.96 in chips) 
Seat 4: Vika76 ($2.19 in chips) 
Seat 5: sunmt ($2.37 in chips) 
Seat 6: rideraa ($5.36 in chips) 
Seat 7: Feloniously1 ($2.70 in chips) 
Seat 8: tranemaster ($3.74 in chips) 
Seat 9: sapopez ($2.41 in chips) 
ku12: posts small blind $0.01
bandit707: posts big blind $0.02
*** HOLE CARDS ***
Dealt to sunmt [9d 3h]
Vika76: folds 
sunmt: folds 
rideraa: folds 
Feloniously1: calls $0.02
tranemaster: folds 
sapopez: raises $0.10 to $0.12
epigmenio77: folds 
ku12: folds 
bandit707: folds 
Feloniously1: folds 
Uncalled bet ($0.10) returned to sapopez
sapopez collected $0.07 from pot
sapopez: doesn't show hand 
*** SUMMARY ***
Total pot $0.07 | Rake $0 
Seat 1: epigmenio77 (button) folded before Flop (didn't bet)
Seat 2: ku12 (small blind) folded before Flop
Seat 3: bandit707 (big blind) folded before Flop
Seat 4: Vika76 folded before Flop (didn't bet)
Seat 5: sunmt folded before Flop (didn't bet)
Seat 6: rideraa folded before Flop (didn't bet)
Seat 7: Feloniously1 folded before Flop
Seat 8: tranemaster folded before Flop (didn't bet)
Seat 9: sapopez collected ($0.07)



PokerStars Game #24446621105:  Hold'em No Limit ($0.01/$0.02) - 2009/01/30 21:52:35 ET
Table 'Adalberta III' 9-max Seat #2 is the button
Seat 1: epigmenio77 ($1.73 in chips) 
Seat 2: ku12 ($2.97 in chips) 
Seat 3: bandit707 ($0.94 in chips) 
Seat 4: Vika76 ($2.19 in chips) 
Seat 5: sunmt ($2.37 in chips) 
Seat 6: rideraa ($5.36 in chips) 
Seat 7: Feloniously1 ($2.68 in chips) 
Seat 8: tranemaster ($3.74 in chips) 
Seat 9: sapopez ($2.46 in chips) 
bandit707: posts small blind $0.01
Vika76: posts big blind $0.02
*** HOLE CARDS ***
Dealt to sunmt [Kh 9c]
sunmt: folds 
rideraa: folds 
Feloniously1: folds 
tranemaster: calls $0.02
sapopez: folds 
epigmenio77: raises $0.08 to $0.10
ku12: folds 
bandit707: folds 
Vika76: folds 
tranemaster: calls $0.08
*** FLOP *** [Qc Qd 4d]
tranemaster: checks 
epigmenio77: bets $0.13
tranemaster: folds 
Uncalled bet ($0.13) returned to epigmenio77
epigmenio77 collected $0.23 from pot
*** SUMMARY ***
Total pot $0.23 | Rake $0 
Board [Qc Qd 4d]
Seat 1: epigmenio77 collected ($0.23)
Seat 2: ku12 (button) folded before Flop (didn't bet)
Seat 3: bandit707 (small blind) folded before Flop
Seat 4: Vika76 (big blind) folded before Flop
Seat 5: sunmt folded before Flop (didn't bet)
Seat 6: rideraa folded before Flop (didn't bet)
Seat 7: Feloniously1 folded before Flop (didn't bet)
Seat 8: tranemaster folded on the Flop
Seat 9: sapopez folded before Flop (didn't bet)



PokerStars Game #24446656451:  Hold'em No Limit ($0.01/$0.02) - 2009/01/30 21:53:52 ET
Table 'Adalberta III' 9-max Seat #3 is the button
Seat 1: epigmenio77 ($1.86 in chips) 
Seat 2: ku12 ($2.97 in chips) 
Seat 3: bandit707 ($0.93 in chips) 
Seat 4: Vika76 ($2.17 in chips) 
Seat 5: sunmt ($2.37 in chips) 
Seat 6: rideraa ($5.36 in chips) 
Seat 7: Feloniously1 ($2.68 in chips) 
Seat 8: tranemaster ($3.64 in chips) 
Seat 9: sapopez ($2.46 in chips) 
Vika76: posts small blind $0.01
sunmt: posts big blind $0.02
*** HOLE CARDS ***
Dealt to sunmt [Jh 7d]
rideraa: folds 
Feloniously1: raises $0.06 to $0.08
tranemaster: folds 
sapopez: folds 
epigmenio77: folds 
ku12: folds 
bandit707: folds 
Vika76: folds 
sunmt: folds 
Uncalled bet ($0.06) returned to Feloniously1
Feloniously1 collected $0.05 from pot
*** SUMMARY ***
Total pot $0.05 | Rake $0 
Seat 1: epigmenio77 folded before Flop (didn't bet)
Seat 2: ku12 folded before Flop (didn't bet)
Seat 3: bandit707 (button) folded before Flop (didn't bet)
Seat 4: Vika76 (small blind) folded before Flop
Seat 5: sunmt (big blind) folded before Flop
Seat 6: rideraa folded before Flop (didn't bet)
Seat 7: Feloniously1 collected ($0.05)
Seat 8: tranemaster folded before Flop (didn't bet)
Seat 9: sapopez folded before Flop (didn't bet)



PokerStars Game #24446672027:  Hold'em No Limit ($0.01/$0.02) - 2009/01/30 21:54:26 ET
Table 'Adalberta III' 9-max Seat #4 is the button
Seat 1: epigmenio77 ($1.86 in chips) 
Seat 2: ku12 ($2.97 in chips) 
Seat 3: bandit707 ($0.93 in chips) 
Seat 4: Vika76 ($2.16 in chips) 
Seat 5: sunmt ($2.35 in chips) 
Seat 6: rideraa ($5.36 in chips) 
Seat 7: Feloniously1 ($2.71 in chips) 
Seat 8: tranemaster ($3.64 in chips) 
Seat 9: sapopez ($2.46 in chips) 
sunmt: posts small blind $0.01
rideraa: posts big blind $0.02
*** HOLE CARDS ***
Dealt to sunmt [Qh Qd]
Feloniously1: folds 
tranemaster: folds 
sapopez: folds 
epigmenio77: calls $0.02
ku12: calls $0.02
bandit707: folds 
Vika76: calls $0.02
sunmt: raises $0.06 to $0.08
rideraa: folds 
epigmenio77: calls $0.06
ku12: calls $0.06
Vika76: calls $0.06
*** FLOP *** [9c 4s Kh]
sunmt: checks 
epigmenio77: checks 
ku12: checks 
Vika76: checks 
*** TURN *** [9c 4s Kh] [2s]
sunmt: checks 
epigmenio77: checks 
ku12: checks 
Vika76: checks 
*** RIVER *** [9c 4s Kh 2s] [6d]
sunmt: checks 
epigmenio77: checks 
ku12: checks 
Vika76: checks 
*** SHOW DOWN ***
sunmt: shows [Qh Qd] (a pair of Queens)
epigmenio77: mucks hand 
ku12: mucks hand 
Vika76: mucks hand 
sunmt collected $0.34 from pot
*** SUMMARY ***
Total pot $0.34 | Rake $0 
Board [9c 4s Kh 2s 6d]
Seat 1: epigmenio77 mucked [Th Jd]
Seat 2: ku12 mucked [Js Jh]
Seat 3: bandit707 folded before Flop (didn't bet)
Seat 4: Vika76 (button) mucked [7s 6c]
Seat 5: sunmt (small blind) showed [Qh Qd] and won ($0.34) with a pair of Queens
Seat 6: rideraa (big blind) folded before Flop
Seat 7: Feloniously1 folded before Flop (didn't bet)
Seat 8: tranemaster folded before Flop (didn't bet)
Seat 9: sapopez folded before Flop (didn't bet)



PokerStars Game #24446719666:  Hold'em No Limit ($0.01/$0.02) - 2009/01/30 21:56:11 ET
Table 'Adalberta III' 9-max Seat #5 is the button
Seat 1: epigmenio77 ($1.78 in chips) 
Seat 2: ku12 ($2.89 in chips) 
Seat 3: bandit707 ($0.93 in chips) 
Seat 4: Vika76 ($2.08 in chips) 
Seat 5: sunmt ($2.61 in chips) 
Seat 6: rideraa ($5.34 in chips) 
Seat 7: Feloniously1 ($2.71 in chips) 
Seat 8: tranemaster ($3.64 in chips) 
Seat 9: sapopez ($2.46 in chips) 
rideraa: posts small blind $0.01
Feloniously1: posts big blind $0.02
*** HOLE CARDS ***
Dealt to sunmt [3d Qs]
tranemaster: folds 
sapopez: folds 
epigmenio77: folds 
ku12: folds 
bandit707: folds 
Vika76: calls $0.02
sunmt: folds 
rideraa: folds 
Feloniously1: checks 
*** FLOP *** [Ks Tc 8d]
Feloniously1: checks 
Vika76: checks 
*** TURN *** [Ks Tc 8d] [6s]
Feloniously1: checks 
Vika76: checks 
*** RIVER *** [Ks Tc 8d 6s] [4s]
Feloniously1: checks 
Vika76: checks 
*** SHOW DOWN ***
Feloniously1: shows [3c 7d] (high card King)
Vika76: shows [Ah 6d] (a pair of Sixes)
Vika76 collected $0.05 from pot
*** SUMMARY ***
Total pot $0.05 | Rake $0 
Board [Ks Tc 8d 6s 4s]
Seat 1: epigmenio77 folded before Flop (didn't bet)
Seat 2: ku12 folded before Flop (didn't bet)
Seat 3: bandit707 folded before Flop (didn't bet)
Seat 4: Vika76 showed [Ah 6d] and won ($0.05) with a pair of Sixes
Seat 5: sunmt (button) folded before Flop (didn't bet)
Seat 6: rideraa (small blind) folded before Flop
Seat 7: Feloniously1 (big blind) showed [3c 7d] and lost with high card King
Seat 8: tranemaster folded before Flop (didn't bet)
Seat 9: sapopez folded before Flop (didn't bet)



PokerStars Game #24446755350:  Hold'em No Limit ($0.01/$0.02) - 2009/01/30 21:57:30 ET
Table 'Adalberta III' 9-max Seat #6 is the button
Seat 1: epigmenio77 ($1.78 in chips) 
Seat 2: ku12 ($2.89 in chips) 
Seat 3: bandit707 ($0.93 in chips) 
Seat 4: Vika76 ($2.11 in chips) 
Seat 5: sunmt ($2.61 in chips) 
Seat 6: rideraa ($5.33 in chips) 
Seat 7: Feloniously1 ($2.69 in chips) 
Seat 8: tranemaster ($3.64 in chips) 
Seat 9: sapopez ($2.46 in chips) 
Feloniously1: posts small blind $0.01
tranemaster: posts big blind $0.02
*** HOLE CARDS ***
Dealt to sunmt [Ah 4d]
sapopez: folds 
epigmenio77: raises $0.06 to $0.08
ku12: folds 
bandit707: folds 
Vika76: folds 
sunmt: folds 
rideraa: folds 
Feloniously1: calls $0.07
tranemaster: folds 
*** FLOP *** [7s 7d 4s]
Feloniously1: checks 
epigmenio77: bets $0.12
Feloniously1: raises $2.49 to $2.61 and is all-in
epigmenio77: folds 
Uncalled bet ($2.49) returned to Feloniously1
Feloniously1 collected $0.42 from pot
Feloniously1: doesn't show hand 
*** SUMMARY ***
Total pot $0.42 | Rake $0 
Board [7s 7d 4s]
Seat 1: epigmenio77 folded on the Flop
Seat 2: ku12 folded before Flop (didn't bet)
Seat 3: bandit707 folded before Flop (didn't bet)
Seat 4: Vika76 folded before Flop (didn't bet)
Seat 5: sunmt folded before Flop (didn't bet)
Seat 6: rideraa (button) folded before Flop (didn't bet)
Seat 7: Feloniously1 (small blind) collected ($0.42)
Seat 8: tranemaster (big blind) folded before Flop
Seat 9: sapopez folded before Flop (didn't bet)



PokerStars Game #24446788818:  Hold'em No Limit ($0.01/$0.02) - 2009/01/30 21:58:44 ET
Table 'Adalberta III' 9-max Seat #7 is the button
Seat 1: epigmenio77 ($1.58 in chips) 
Seat 2: ku12 ($2.89 in chips) 
Seat 3: bandit707 ($0.93 in chips) 
Seat 4: Vika76 ($2.11 in chips) 
Seat 5: sunmt ($2.61 in chips) 
Seat 6: rideraa ($5.33 in chips) 
Seat 7: Feloniously1 ($2.91 in chips) 
Seat 8: tranemaster ($3.62 in chips) 
Seat 9: sapopez ($2.46 in chips) 
tranemaster: posts small blind $0.01
sapopez: posts big blind $0.02
*** HOLE CARDS ***
Dealt to sunmt [6s 6d]
epigmenio77: folds 
ku12: folds 
bandit707: calls $0.02
Vika76: folds 
sunmt: raises $0.04 to $0.06
rideraa: folds 
Feloniously1: folds 
tranemaster: calls $0.05
sapopez: folds 
bandit707: calls $0.04
*** FLOP *** [8h 6c Qs]
tranemaster: checks 
bandit707: checks 
sunmt: bets $0.16
tranemaster: folds 
bandit707: folds 
Uncalled bet ($0.16) returned to sunmt
sunmt collected $0.20 from pot
sunmt: doesn't show hand 
*** SUMMARY ***
Total pot $0.20 | Rake $0 
Board [8h 6c Qs]
Seat 1: epigmenio77 folded before Flop (didn't bet)
Seat 2: ku12 folded before Flop (didn't bet)
Seat 3: bandit707 folded on the Flop
Seat 4: Vika76 folded before Flop (didn't bet)
Seat 5: sunmt collected ($0.20)
Seat 6: rideraa folded before Flop (didn't bet)
Seat 7: Feloniously1 (button) folded before Flop (didn't bet)
Seat 8: tranemaster (small blind) folded on the Flop
Seat 9: sapopez (big blind) folded before Flop



PokerStars Game #24446811970:  Hold'em No Limit ($0.01/$0.02) - 2009/01/30 21:59:36 ET
Table 'Adalberta III' 9-max Seat #8 is the button
Seat 1: epigmenio77 ($1.58 in chips) 
Seat 2: ku12 ($2.89 in chips) 
Seat 3: bandit707 ($0.87 in chips) 
Seat 4: Vika76 ($2.11 in chips) 
Seat 5: sunmt ($2.75 in chips) 
Seat 6: rideraa ($5.33 in chips) 
Seat 7: Feloniously1 ($2.91 in chips) 
Seat 8: tranemaster ($3.56 in chips) 
Seat 9: sapopez ($2.44 in chips) 
sapopez: posts small blind $0.01
epigmenio77: posts big blind $0.02
*** HOLE CARDS ***
Dealt to sunmt [Ad 9s]
ku12: folds 
bandit707: folds 
Vika76: folds 
sunmt: folds 
rideraa: folds 
Feloniously1: folds 
tranemaster: folds 
sapopez: raises $0.06 to $0.08
epigmenio77: folds 
Uncalled bet ($0.06) returned to sapopez
sapopez collected $0.04 from pot
sapopez: doesn't show hand 
*** SUMMARY ***
Total pot $0.04 | Rake $0 
Seat 1: epigmenio77 (big blind) folded before Flop
Seat 2: ku12 folded before Flop (didn't bet)
Seat 3: bandit707 folded before Flop (didn't bet)
Seat 4: Vika76 folded before Flop (didn't bet)
Seat 5: sunmt folded before Flop (didn't bet)
Seat 6: rideraa folded before Flop (didn't bet)
Seat 7: Feloniously1 folded before Flop (didn't bet)
Seat 8: tranemaster (button) folded before Flop (didn't bet)
Seat 9: sapopez (small blind) collected ($0.04)



PokerStars Game #24446834085:  Hold'em No Limit ($0.01/$0.02) - 2009/01/30 22:00:22 ET
Table 'Adalberta III' 9-max Seat #9 is the button
Seat 1: epigmenio77 ($1.56 in chips) 
Seat 2: ku12 ($2.89 in chips) 
Seat 3: bandit707 ($0.87 in chips) 
Seat 4: Vika76 ($2.11 in chips) 
Seat 5: sunmt ($2.75 in chips) 
Seat 6: rideraa ($5.33 in chips) 
Seat 7: Feloniously1 ($2.91 in chips) 
Seat 8: tranemaster ($3.56 in chips) 
Seat 9: sapopez ($2.46 in chips) 
epigmenio77: posts small blind $0.01
ku12: posts big blind $0.02
*** HOLE CARDS ***
Dealt to sunmt [Qs 2h]
bandit707: calls $0.02
Vika76: calls $0.02
sunmt: folds 
rideraa: folds 
Feloniously1: folds 
tranemaster: folds 
sapopez: folds 
epigmenio77: folds 
ku12: checks 
*** FLOP *** [5s 3s 9d]
ku12: checks 
bandit707: bets $0.04
Vika76: folds 
ku12: folds 
Uncalled bet ($0.04) returned to bandit707
bandit707 collected $0.07 from pot
bandit707 is sitting out
*** SUMMARY ***
Total pot $0.07 | Rake $0 
Board [5s 3s 9d]
Seat 1: epigmenio77 (small blind) folded before Flop
Seat 2: ku12 (big blind) folded on the Flop
Seat 3: bandit707 collected ($0.07)
Seat 4: Vika76 folded on the Flop
Seat 5: sunmt folded before Flop (didn't bet)
Seat 6: rideraa folded before Flop (didn't bet)
Seat 7: Feloniously1 folded before Flop (didn't bet)
Seat 8: tranemaster folded before Flop (didn't bet)
Seat 9: sapopez (button) folded before Flop (didn't bet)



PokerStars Game #24446863799:  Hold'em No Limit ($0.01/$0.02) - 2009/01/30 22:01:28 ET
Table 'Adalberta III' 9-max Seat #1 is the button
Seat 1: epigmenio77 ($1.55 in chips) 
Seat 2: ku12 ($2.87 in chips) 
Seat 4: Vika76 ($2.09 in chips) 
Seat 5: sunmt ($2.75 in chips) 
Seat 6: rideraa ($5.33 in chips) 
Seat 7: Feloniously1 ($2.91 in chips) 
Seat 8: tranemaster ($3.56 in chips) 
Seat 9: sapopez ($2.46 in chips) 
bandit707 leaves the table
ku12: posts small blind $0.01
Vika76: posts big blind $0.02
*** HOLE CARDS ***
Dealt to sunmt [Ah 9s]
sunmt: folds 
cfishing joins the table at seat #3 
rideraa: folds 
Feloniously1: folds 
tranemaster: folds 
sapopez: folds 
epigmenio77: calls $0.02
ku12: calls $0.01
Vika76: checks 
*** FLOP *** [4s 4h Ac]
ku12: checks 
Vika76: checks 
epigmenio77: checks 
*** TURN *** [4s 4h Ac] [7c]
ku12: checks 
Vika76: checks 
epigmenio77: checks 
*** RIVER *** [4s 4h Ac 7c] [9d]
ku12: checks 
Vika76: checks 
epigmenio77: checks 
*** SHOW DOWN ***
ku12: shows [Jd As] (two pair, Aces and Fours)
Vika76: mucks hand 
epigmenio77: mucks hand 
ku12 collected $0.06 from pot
*** SUMMARY ***
Total pot $0.06 | Rake $0 
Board [4s 4h Ac 7c 9d]
Seat 1: epigmenio77 (button) mucked [5h 2h]
Seat 2: ku12 (small blind) showed [Jd As] and won ($0.06) with two pair, Aces and Fours
Seat 4: Vika76 (big blind) mucked [Ks 7s]
Seat 5: sunmt folded before Flop (didn't bet)
Seat 6: rideraa folded before Flop (didn't bet)
Seat 7: Feloniously1 folded before Flop (didn't bet)
Seat 8: tranemaster folded before Flop (didn't bet)
Seat 9: sapopez folded before Flop (didn't bet)



PokerStars Game #24446895055:  Hold'em No Limit ($0.01/$0.02) - 2009/01/30 22:02:34 ET
Table 'Adalberta III' 9-max Seat #2 is the button
Seat 1: epigmenio77 ($1.53 in chips) 
Seat 2: ku12 ($2.91 in chips) 
Seat 4: Vika76 ($2.07 in chips) 
Seat 5: sunmt ($2.75 in chips) 
Seat 6: rideraa ($5.33 in chips) 
Seat 7: Feloniously1 ($2.91 in chips) 
Seat 8: tranemaster ($3.56 in chips) 
Seat 9: sapopez ($2.46 in chips) 
cfishing will be allowed to play after the button
Vika76: posts small blind $0.01
sunmt: posts big blind $0.02
*** HOLE CARDS ***
Dealt to sunmt [Ac 2s]
rideraa: folds 
Feloniously1: raises $0.06 to $0.08
tranemaster: folds 
sapopez: folds 
epigmenio77: folds 
ku12: folds 
Vika76: folds 
sunmt: folds 
Uncalled bet ($0.06) returned to Feloniously1
Feloniously1 collected $0.05 from pot
*** SUMMARY ***
Total pot $0.05 | Rake $0 
Seat 1: epigmenio77 folded before Flop (didn't bet)
Seat 2: ku12 (button) folded before Flop (didn't bet)
Seat 4: Vika76 (small blind) folded before Flop
Seat 5: sunmt (big blind) folded before Flop
Seat 6: rideraa folded before Flop (didn't bet)
Seat 7: Feloniously1 collected ($0.05)
Seat 8: tranemaster folded before Flop (didn't bet)
Seat 9: sapopez folded before Flop (didn't bet)



PokerStars Game #24446912713:  Hold'em No Limit ($0.01/$0.02) - 2009/01/30 22:03:12 ET
Table 'Adalberta III' 9-max Seat #4 is the button
Seat 1: epigmenio77 ($1.53 in chips) 
Seat 2: ku12 ($2.91 in chips) 
Seat 3: cfishing ($1 in chips) 
Seat 4: Vika76 ($2.06 in chips) 
Seat 5: sunmt ($2.73 in chips) 
Seat 6: rideraa ($5.33 in chips) 
Seat 7: Feloniously1 ($2.94 in chips) 
Seat 8: tranemaster ($3.56 in chips) 
Seat 9: sapopez ($2.46 in chips) 
sunmt: posts small blind $0.01
rideraa: posts big blind $0.02
cfishing: posts big blind $0.02
*** HOLE CARDS ***
Dealt to sunmt [Th Kc]
Feloniously1: folds 
tranemaster: folds 
sapopez: folds 
epigmenio77: folds 
ku12: folds 
cfishing: checks 
Vika76: calls $0.02
sunmt: folds 
rideraa: checks 
*** FLOP *** [Qs Ts 9s]
rideraa: checks 
cfishing: bets $0.08
Vika76: folds 
rideraa: calls $0.08
*** TURN *** [Qs Ts 9s] [7s]
rideraa: checks 
cfishing: checks 
*** RIVER *** [Qs Ts 9s 7s] [3s]
rideraa: bets $3.48
cfishing: folds 
Uncalled bet ($3.48) returned to rideraa
rideraa collected $0.23 from pot
*** SUMMARY ***
Total pot $0.23 | Rake $0 
Board [Qs Ts 9s 7s 3s]
Seat 1: epigmenio77 folded before Flop (didn't bet)
Seat 2: ku12 folded before Flop (didn't bet)
Seat 3: cfishing folded on the River
Seat 4: Vika76 (button) folded on the Flop
Seat 5: sunmt (small blind) folded before Flop
Seat 6: rideraa (big blind) collected ($0.23)
Seat 7: Feloniously1 folded before Flop (didn't bet)
Seat 8: tranemaster folded before Flop (didn't bet)
Seat 9: sapopez folded before Flop (didn't bet)



PokerStars Game #24446973210:  Hold'em No Limit ($0.01/$0.02) - 2009/01/30 22:05:19 ET
Table 'Adalberta III' 9-max Seat #5 is the button
Seat 1: epigmenio77 ($1.53 in chips) 
Seat 2: ku12 ($2.91 in chips) 
Seat 3: cfishing ($0.90 in chips) 
Seat 4: Vika76 ($2.04 in chips) 
Seat 5: sunmt ($2.72 in chips) 
Seat 6: rideraa ($5.46 in chips) 
Seat 7: Feloniously1 ($2.94 in chips) 
Seat 8: tranemaster ($3.56 in chips) 
Seat 9: sapopez ($2.46 in chips) 
rideraa: posts small blind $0.01
Feloniously1: posts big blind $0.02
*** HOLE CARDS ***
Dealt to sunmt [7c 7d]
tranemaster: folds 
sapopez: folds 
epigmenio77: calls $0.02
ku12: folds 
cfishing: calls $0.02
Vika76: calls $0.02
sunmt: raises $0.04 to $0.06
rideraa: calls $0.05
Feloniously1: calls $0.04
epigmenio77: calls $0.04
cfishing: calls $0.04
Vika76: folds 
*** FLOP *** [4d 6s Qd]
rideraa: checks 
Feloniously1: checks 
epigmenio77: checks 
cfishing: checks 
sunmt: checks 
*** TURN *** [4d 6s Qd] [8s]
rideraa: checks 
Feloniously1: bets $0.04
epigmenio77: folds 
cfishing: calls $0.04
sunmt: calls $0.04
rideraa: folds 
*** RIVER *** [4d 6s Qd 8s] [Th]
Feloniously1: checks 
cfishing: checks 
sunmt: checks 
*** SHOW DOWN ***
Feloniously1: shows [8d 9d] (a pair of Eights)
cfishing: mucks hand 
sunmt: mucks hand 
Feloniously1 collected $0.44 from pot
*** SUMMARY ***
Total pot $0.44 | Rake $0 
Board [4d 6s Qd 8s Th]
Seat 1: epigmenio77 folded on the Turn
Seat 2: ku12 folded before Flop (didn't bet)
Seat 3: cfishing mucked [5h 5s]
Seat 4: Vika76 folded before Flop
Seat 5: sunmt (button) mucked [7c 7d]
Seat 6: rideraa (small blind) folded on the Turn
Seat 7: Feloniously1 (big blind) showed [8d 9d] and won ($0.44) with a pair of Eights
Seat 8: tranemaster folded before Flop (didn't bet)
Seat 9: sapopez folded before Flop (didn't bet)



PokerStars Game #24447037041:  Hold'em No Limit ($0.01/$0.02) - 2009/01/30 22:07:35 ET
Table 'Adalberta III' 9-max Seat #6 is the button
Seat 1: epigmenio77 ($1.47 in chips) 
Seat 2: ku12 ($2.91 in chips) 
Seat 3: cfishing ($0.80 in chips) 
Seat 4: Vika76 ($2.02 in chips) 
Seat 5: sunmt ($2.62 in chips) 
Seat 6: rideraa ($5.40 in chips) 
Seat 7: Feloniously1 ($3.28 in chips) 
Seat 8: tranemaster ($3.56 in chips) 
Seat 9: sapopez ($2.46 in chips) 
Feloniously1: posts small blind $0.01
tranemaster: posts big blind $0.02
*** HOLE CARDS ***
Dealt to sunmt [2s 7d]
sapopez: folds 
epigmenio77: calls $0.02
ku12: calls $0.02
cfishing: folds 
Vika76: folds 
sunmt: folds 
rideraa: folds 
Feloniously1: calls $0.01
tranemaster: checks 
*** FLOP *** [Kh 7h As]
Feloniously1: checks 
tranemaster: checks 
epigmenio77: checks 
ku12: checks 
*** TURN *** [Kh 7h As] [8h]
Feloniously1: checks 
tranemaster: checks 
epigmenio77: checks 
ku12: checks 
*** RIVER *** [Kh 7h As 8h] [6d]
Feloniously1: bets $0.06
tranemaster: folds 
epigmenio77: folds 
ku12: folds 
Uncalled bet ($0.06) returned to Feloniously1
Feloniously1 collected $0.08 from pot
*** SUMMARY ***
Total pot $0.08 | Rake $0 
Board [Kh 7h As 8h 6d]
Seat 1: epigmenio77 folded on the River
Seat 2: ku12 folded on the River
Seat 3: cfishing folded before Flop (didn't bet)
Seat 4: Vika76 folded before Flop (didn't bet)
Seat 5: sunmt folded before Flop (didn't bet)
Seat 6: rideraa (button) folded before Flop (didn't bet)
Seat 7: Feloniously1 (small blind) collected ($0.08)
Seat 8: tranemaster (big blind) folded on the River
Seat 9: sapopez folded before Flop (didn't bet)



PokerStars Game #24447087697:  Hold'em No Limit ($0.01/$0.02) - 2009/01/30 22:09:23 ET
Table 'Adalberta III' 9-max Seat #7 is the button
Seat 1: epigmenio77 ($1.45 in chips) 
Seat 2: ku12 ($2.89 in chips) 
Seat 3: cfishing ($0.80 in chips) 
Seat 4: Vika76 ($2.02 in chips) 
Seat 5: sunmt ($2.62 in chips) 
Seat 6: rideraa ($5.40 in chips) 
Seat 7: Feloniously1 ($3.34 in chips) 
Seat 8: tranemaster ($3.54 in chips) 
Seat 9: sapopez ($2.46 in chips) 
tranemaster: posts small blind $0.01
sapopez: posts big blind $0.02
*** HOLE CARDS ***
Dealt to sunmt [4c Th]
epigmenio77: folds 
ku12: folds 
cfishing: folds 
Vika76: folds 
sunmt: folds 
rideraa: folds 
Feloniously1: calls $0.02
tranemaster: folds 
sapopez: raises $0.06 to $0.08
Feloniously1: calls $0.06
*** FLOP *** [Ad 9c Kd]
sapopez: bets $0.16
Feloniously1: calls $0.16
*** TURN *** [Ad 9c Kd] [8c]
sapopez: bets $0.36
Feloniously1: folds 
Uncalled bet ($0.36) returned to sapopez
Feloniously1 is sitting out
Feloniously1 leaves the table
sapopez collected $0.49 from pot
sapopez: doesn't show hand 
*** SUMMARY ***
Total pot $0.49 | Rake $0 
Board [Ad 9c Kd 8c]
Seat 1: epigmenio77 folded before Flop (didn't bet)
Seat 2: ku12 folded before Flop (didn't bet)
Seat 3: cfishing folded before Flop (didn't bet)
Seat 4: Vika76 folded before Flop (didn't bet)
Seat 5: sunmt folded before Flop (didn't bet)
Seat 6: rideraa folded before Flop (didn't bet)
Seat 7: Feloniously1 (button) folded on the Turn
Seat 8: tranemaster (small blind) folded before Flop
Seat 9: sapopez (big blind) collected ($0.49)



PokerStars Game #24447123335:  Hold'em No Limit ($0.01/$0.02) - 2009/01/30 22:10:40 ET
Table 'Adalberta III' 9-max Seat #8 is the button
Seat 1: epigmenio77 ($1.45 in chips) 
Seat 2: ku12 ($2.89 in chips) 
Seat 3: cfishing ($0.80 in chips) 
Seat 4: Vika76 ($2.02 in chips) 
Seat 5: sunmt ($2.62 in chips) 
Seat 6: rideraa ($5.40 in chips) 
Seat 8: tranemaster ($3.53 in chips) 
Seat 9: sapopez ($2.71 in chips) 
sapopez: posts small blind $0.01
epigmenio77: posts big blind $0.02
*** HOLE CARDS ***
Dealt to sunmt [7d 4c]
ku12: folds 
cfishing: folds 
Vika76: folds 
sunmt: folds 
rideraa: calls $0.02
tranemaster: folds 
sapopez: calls $0.01
McMendes joins the table at seat #7 
epigmenio77: checks 
*** FLOP *** [9c 5s 5c]
sapopez: checks 
epigmenio77: checks 
rideraa: checks 
*** TURN *** [9c 5s 5c] [Th]
sapopez: checks 
epigmenio77: checks 
rideraa: checks 
*** RIVER *** [9c 5s 5c Th] [3h]
sapopez: checks 
epigmenio77: checks 
rideraa: checks 
*** SHOW DOWN ***
sapopez: shows [Jh Qs] (a pair of Fives)
epigmenio77: shows [3c 2d] (two pair, Fives and Threes)
rideraa: mucks hand 
epigmenio77 collected $0.06 from pot
*** SUMMARY ***
Total pot $0.06 | Rake $0 
Board [9c 5s 5c Th 3h]
Seat 1: epigmenio77 (big blind) showed [3c 2d] and won ($0.06) with two pair, Fives and Threes
Seat 2: ku12 folded before Flop (didn't bet)
Seat 3: cfishing folded before Flop (didn't bet)
Seat 4: Vika76 folded before Flop (didn't bet)
Seat 5: sunmt folded before Flop (didn't bet)
Seat 6: rideraa mucked [As Kd]
Seat 8: tranemaster (button) folded before Flop (didn't bet)
Seat 9: sapopez (small blind) showed [Jh Qs] and lost with a pair of Fives



PokerStars Game #24447159109:  Hold'em No Limit ($0.01/$0.02) - 2009/01/30 22:11:57 ET
Table 'Adalberta III' 9-max Seat #9 is the button
Seat 1: epigmenio77 ($1.49 in chips) 
Seat 2: ku12 ($2.89 in chips) 
Seat 3: cfishing ($0.80 in chips) 
Seat 4: Vika76 ($2.02 in chips) 
Seat 5: sunmt ($2.62 in chips) 
Seat 6: rideraa ($5.38 in chips) 
Seat 7: McMendes ($2.50 in chips) 
Seat 8: tranemaster ($3.53 in chips) 
Seat 9: sapopez ($2.69 in chips) 
epigmenio77: posts small blind $0.01
ku12: posts big blind $0.02
McMendes: posts big blind $0.02
*** HOLE CARDS ***
Dealt to sunmt [6d Qd]
cfishing: folds 
Vika76: folds 
sunmt: folds 
rideraa: folds 
McMendes: checks 
tranemaster: folds 
sapopez: folds 
epigmenio77: folds 
epigmenio77 is sitting out
ku12: checks 
*** FLOP *** [8h Kd 3c]
epigmenio77 leaves the table
ku12: checks 
McMendes: checks 
*** TURN *** [8h Kd 3c] [9h]
cjordan3 joins the table at seat #1 
ku12: checks 
McMendes: bets $0.06
ku12: folds 
Uncalled bet ($0.06) returned to McMendes
McMendes collected $0.05 from pot
McMendes: doesn't show hand 
*** SUMMARY ***
Total pot $0.05 | Rake $0 
Board [8h Kd 3c 9h]
Seat 1: epigmenio77 (small blind) folded before Flop
Seat 2: ku12 (big blind) folded on the Turn
Seat 3: cfishing folded before Flop (didn't bet)
Seat 4: Vika76 folded before Flop (didn't bet)
Seat 5: sunmt folded before Flop (didn't bet)
Seat 6: rideraa folded before Flop (didn't bet)
Seat 7: McMendes collected ($0.05)
Seat 8: tranemaster folded before Flop (didn't bet)
Seat 9: sapopez (button) folded before Flop (didn't bet)



PokerStars Game #24447196357:  Hold'em No Limit ($0.01/$0.02) - 2009/01/30 22:13:17 ET
Table 'Adalberta III' 9-max Seat #2 is the button
Seat 1: cjordan3 ($2 in chips) 
Seat 2: ku12 ($2.87 in chips) 
Seat 3: cfishing ($0.80 in chips) 
Seat 4: Vika76 ($2.02 in chips) 
Seat 5: sunmt ($2.62 in chips) 
Seat 6: rideraa ($5.38 in chips) 
Seat 7: McMendes ($2.53 in chips) 
Seat 8: tranemaster ($3.53 in chips) 
Seat 9: sapopez ($2.69 in chips) 
cfishing: posts small blind $0.01
Vika76: posts big blind $0.02
cjordan3: posts big blind $0.02
*** HOLE CARDS ***
Dealt to sunmt [8d Kd]
sunmt: folds 
rideraa: folds 
McMendes: folds 
tranemaster: calls $0.02
sapopez: calls $0.02
cjordan3: checks 
ku12: calls $0.02
cfishing: calls $0.01
Vika76: checks 
*** FLOP *** [Qc Ac 4c]
cfishing: checks 
Vika76: checks 
tranemaster: checks 
sapopez: checks 
cjordan3: checks 
ku12: checks 
*** TURN *** [Qc Ac 4c] [Js]
cfishing: bets $0.12
Vika76: folds 
tranemaster: folds 
sapopez: folds 
cjordan3: folds 
ku12: calls $0.12
*** RIVER *** [Qc Ac 4c Js] [Qd]
cfishing: bets $0.34
ku12: folds 
Uncalled bet ($0.34) returned to cfishing
cfishing collected $0.36 from pot
cfishing: doesn't show hand 
*** SUMMARY ***
Total pot $0.36 | Rake $0 
Board [Qc Ac 4c Js Qd]
Seat 1: cjordan3 folded on the Turn
Seat 2: ku12 (button) folded on the River
Seat 3: cfishing (small blind) collected ($0.36)
Seat 4: Vika76 (big blind) folded on the Turn
Seat 5: sunmt folded before Flop (didn't bet)
Seat 6: rideraa folded before Flop (didn't bet)
Seat 7: McMendes folded before Flop (didn't bet)
Seat 8: tranemaster folded on the Turn
Seat 9: sapopez folded on the Turn



PokerStars Game #24447245668:  Hold'em No Limit ($0.01/$0.02) - 2009/01/30 22:15:03 ET
Table 'Adalberta III' 9-max Seat #3 is the button
Seat 1: cjordan3 ($1.98 in chips) 
Seat 2: ku12 ($2.73 in chips) 
Seat 3: cfishing ($1.02 in chips) 
Seat 4: Vika76 ($2 in chips) 
Seat 5: sunmt ($2.62 in chips) 
Seat 6: rideraa ($5.38 in chips) 
Seat 7: McMendes ($2.53 in chips) 
Seat 8: tranemaster ($3.51 in chips) 
Seat 9: sapopez ($2.67 in chips) 
Vika76: posts small blind $0.01
sunmt: posts big blind $0.02
*** HOLE CARDS ***
Dealt to sunmt [9c Ts]
rideraa: folds 
McMendes: folds 
tranemaster: calls $0.02
sapopez: folds 
cjordan3: folds 
ku12: folds 
cfishing: calls $0.02
Vika76: raises $0.10 to $0.12
sunmt: folds 
tranemaster: calls $0.10
cfishing has timed out
cfishing: folds 
*** FLOP *** [8c 2d 9s]
cfishing is sitting out
Vika76: checks 
tranemaster: checks 
*** TURN *** [8c 2d 9s] [5d]
Vika76: checks 
tranemaster: bets $0.22
Vika76: folds 
Uncalled bet ($0.22) returned to tranemaster
tranemaster collected $0.28 from pot
tranemaster: doesn't show hand 
*** SUMMARY ***
Total pot $0.28 | Rake $0 
Board [8c 2d 9s 5d]
Seat 1: cjordan3 folded before Flop (didn't bet)
Seat 2: ku12 folded before Flop (didn't bet)
Seat 3: cfishing (button) folded before Flop
Seat 4: Vika76 (small blind) folded on the Turn
Seat 5: sunmt (big blind) folded before Flop
Seat 6: rideraa folded before Flop (didn't bet)
Seat 7: McMendes folded before Flop (didn't bet)
Seat 8: tranemaster collected ($0.28)
Seat 9: sapopez folded before Flop (didn't bet)



PokerStars Game #24447301794:  Hold'em No Limit ($0.01/$0.02) - 2009/01/30 22:17:06 ET
Table 'Adalberta III' 9-max Seat #4 is the button
Seat 1: cjordan3 ($1.98 in chips) 
Seat 2: ku12 ($2.73 in chips) 
Seat 4: Vika76 ($2 in chips) 
Seat 5: sunmt ($2.60 in chips) 
Seat 6: rideraa ($5.38 in chips) 
Seat 7: McMendes ($2.53 in chips) 
Seat 8: tranemaster ($3.67 in chips) 
Seat 9: sapopez ($2.67 in chips) 
sunmt: posts small blind $0.01
cfishing has returned
rideraa: posts big blind $0.02
*** HOLE CARDS ***
Dealt to sunmt [As 2c]
McMendes: folds 
tranemaster: folds 
sapopez: folds 
cjordan3: folds 
ku12: folds 
Vika76: folds 
sunmt: calls $0.01
rideraa: checks 
*** FLOP *** [Jc 8h 3d]
sunmt: checks 
rideraa: checks 
*** TURN *** [Jc 8h 3d] [Td]
sunmt: checks 
rideraa: checks 
*** RIVER *** [Jc 8h 3d Td] [6s]
sunmt: checks 
rideraa: checks 
*** SHOW DOWN ***
sunmt: shows [As 2c] (high card Ace)
rideraa: mucks hand 
sunmt collected $0.04 from pot
*** SUMMARY ***
Total pot $0.04 | Rake $0 
Board [Jc 8h 3d Td 6s]
Seat 1: cjordan3 folded before Flop (didn't bet)
Seat 2: ku12 folded before Flop (didn't bet)
Seat 4: Vika76 (button) folded before Flop (didn't bet)
Seat 5: sunmt (small blind) showed [As 2c] and won ($0.04) with high card Ace
Seat 6: rideraa (big blind) mucked [9c 2d]
Seat 7: McMendes folded before Flop (didn't bet)
Seat 8: tranemaster folded before Flop (didn't bet)
Seat 9: sapopez folded before Flop (didn't bet)



PokerStars Game #24447336699:  Hold'em No Limit ($0.01/$0.02) - 2009/01/30 22:18:23 ET
Table 'Adalberta III' 9-max Seat #5 is the button
Seat 1: cjordan3 ($1.98 in chips) 
Seat 2: ku12 ($2.73 in chips) 
Seat 3: cfishing ($1 in chips) 
Seat 4: Vika76 ($2 in chips) 
Seat 5: sunmt ($2.62 in chips) 
Seat 6: rideraa ($5.36 in chips) 
Seat 7: McMendes ($2.53 in chips) 
Seat 8: tranemaster ($3.67 in chips) 
Seat 9: sapopez ($2.67 in chips) 
rideraa: posts small blind $0.01
McMendes: posts big blind $0.02
*** HOLE CARDS ***
Dealt to sunmt [Ac Td]
tranemaster: calls $0.02
sapopez: folds 
cjordan3: calls $0.02
ku12: folds 
cfishing: folds 
Vika76: folds 
sunmt: folds 
rideraa: calls $0.01
McMendes: checks 
*** FLOP *** [Kh Jc Th]
rideraa: bets $0.16
McMendes: raises $0.24 to $0.40
tranemaster: calls $0.40
cjordan3: folds 
rideraa: calls $0.24
*** TURN *** [Kh Jc Th] [7s]
rideraa: checks 
McMendes: checks 
tranemaster: checks 
*** RIVER *** [Kh Jc Th 7s] [8s]
rideraa: checks 
sunmt is disconnected 
sunmt is connected 
McMendes: bets $0.10
tranemaster: folds 
rideraa: calls $0.10
*** SHOW DOWN ***
McMendes: shows [Tc Jd] (two pair, Jacks and Tens)
rideraa: shows [Js Kd] (two pair, Kings and Jacks)
rideraa collected $1.43 from pot
*** SUMMARY ***
Total pot $1.48 | Rake $0.05 
Board [Kh Jc Th 7s 8s]
Seat 1: cjordan3 folded on the Flop
Seat 2: ku12 folded before Flop (didn't bet)
Seat 3: cfishing folded before Flop (didn't bet)
Seat 4: Vika76 folded before Flop (didn't bet)
Seat 5: sunmt (button) folded before Flop (didn't bet)
Seat 6: rideraa (small blind) showed [Js Kd] and won ($1.43) with two pair, Kings and Jacks
Seat 7: McMendes (big blind) showed [Tc Jd] and lost with two pair, Jacks and Tens
Seat 8: tranemaster folded on the River
Seat 9: sapopez folded before Flop (didn't bet)



PokerStars Game #24447401405:  Hold'em No Limit ($0.01/$0.02) - 2009/01/30 22:20:45 ET
Table 'Adalberta III' 9-max Seat #6 is the button
Seat 1: cjordan3 ($1.96 in chips) 
Seat 2: ku12 ($2.73 in chips) 
Seat 3: cfishing ($1 in chips) 
Seat 4: Vika76 ($2 in chips) 
Seat 5: sunmt ($2.62 in chips) 
Seat 6: rideraa ($6.27 in chips) 
Seat 7: McMendes ($2.01 in chips) 
Seat 8: tranemaster ($3.25 in chips) 
Seat 9: sapopez ($2.67 in chips) 
McMendes: posts small blind $0.01
tranemaster: posts big blind $0.02
*** HOLE CARDS ***
Dealt to sunmt [Ah 2h]
sapopez: raises $0.06 to $0.08
cjordan3: calls $0.08
ku12: folds 
ku12 leaves the table
cfishing: folds 
Vika76: folds 
sunmt: calls $0.08
BIGMONMAN joins the table at seat #2 
rideraa: calls $0.08
McMendes: folds 
tranemaster: calls $0.06
*** FLOP *** [Ts Jd 6c]
tranemaster: checks 
sapopez: bets $0.34
cjordan3: folds 
sunmt: folds 
rideraa: folds 
tranemaster: folds 
Uncalled bet ($0.34) returned to sapopez
sapopez collected $0.41 from pot
sapopez: doesn't show hand 
*** SUMMARY ***
Total pot $0.41 | Rake $0 
Board [Ts Jd 6c]
Seat 1: cjordan3 folded on the Flop
Seat 2: ku12 folded before Flop (didn't bet)
Seat 3: cfishing folded before Flop (didn't bet)
Seat 4: Vika76 folded before Flop (didn't bet)
Seat 5: sunmt folded on the Flop
Seat 6: rideraa (button) folded on the Flop
Seat 7: McMendes (small blind) folded before Flop
Seat 8: tranemaster (big blind) folded on the Flop
Seat 9: sapopez collected ($0.41)



PokerStars Game #24447459894:  Hold'em No Limit ($0.01/$0.02) - 2009/01/30 22:22:56 ET
Table 'Adalberta III' 9-max Seat #7 is the button
Seat 1: cjordan3 ($1.88 in chips) 
Seat 2: BIGMONMAN ($1 in chips) 
Seat 3: cfishing ($1 in chips) 
Seat 4: Vika76 ($2 in chips) 
Seat 5: sunmt ($2.54 in chips) 
Seat 6: rideraa ($6.19 in chips) 
Seat 7: McMendes ($2 in chips) 
Seat 8: tranemaster ($3.17 in chips) 
tranemaster: posts small blind $0.01
sapopez: is sitting out 
sapopez leaves the table
cjordan3: posts big blind $0.02
BIGMONMAN: posts big blind $0.02
*** HOLE CARDS ***
Dealt to sunmt [Jc Ts]
BIGMONMAN: checks 
cfishing: calls $0.02
Vika76: calls $0.02
sunmt: raises $0.04 to $0.06
rideraa: folds 
McMendes: folds 
tranemaster: folds 
cjordan3: folds 
BIGMONMAN: folds 
cfishing has timed out
cfishing: folds 
cfishing is sitting out
Vika76: folds 
Uncalled bet ($0.04) returned to sunmt
sunmt collected $0.11 from pot
sunmt: doesn't show hand 
*** SUMMARY ***
Total pot $0.11 | Rake $0 
Seat 1: cjordan3 (big blind) folded before Flop
Seat 2: BIGMONMAN folded before Flop
Seat 3: cfishing folded before Flop
Seat 4: Vika76 folded before Flop
Seat 5: sunmt collected ($0.11)
Seat 6: rideraa folded before Flop (didn't bet)
Seat 7: McMendes (button) folded before Flop (didn't bet)
Seat 8: tranemaster (small blind) folded before Flop



PokerStars Game #24447513716:  Hold'em No Limit ($0.01/$0.02) - 2009/01/30 22:24:58 ET
Table 'Adalberta III' 9-max Seat #8 is the button
Seat 1: cjordan3 ($1.86 in chips) 
Seat 2: BIGMONMAN ($0.98 in chips) 
Seat 4: Vika76 ($2 in chips) 
Seat 5: sunmt ($2.63 in chips) 
Seat 6: rideraa ($6.19 in chips) 
Seat 7: McMendes ($2 in chips) 
Seat 8: tranemaster ($3.16 in chips) 
cjordan3: posts small blind $0.01
BIGMONMAN: posts big blind $0.02
*** HOLE CARDS ***
Dealt to sunmt [4c Ac]
Vika76: folds 
sunmt: calls $0.02
rideraa: folds 
McMendes: calls $0.02
tranemaster: calls $0.02
cjordan3: folds 
BIGMONMAN: checks 
*** FLOP *** [4d Kc 6d]
BIGMONMAN: checks 
sunmt: checks 
McMendes: checks 
tranemaster: checks 
*** TURN *** [4d Kc 6d] [Kh]
BIGMONMAN: checks 
sunmt: checks 
McMendes: checks 
tranemaster: checks 
*** RIVER *** [4d Kc 6d Kh] [3s]
BIGMONMAN: checks 
sunmt: checks 
McMendes: checks 
tranemaster: checks 
*** SHOW DOWN ***
BIGMONMAN: shows [Tc 8h] (a pair of Kings)
sunmt: shows [4c Ac] (two pair, Kings and Fours)
McMendes: mucks hand 
tranemaster: mucks hand 
sunmt collected $0.09 from pot
*** SUMMARY ***
Total pot $0.09 | Rake $0 
Board [4d Kc 6d Kh 3s]
Seat 1: cjordan3 (small blind) folded before Flop
Seat 2: BIGMONMAN (big blind) showed [Tc 8h] and lost with a pair of Kings
Seat 4: Vika76 folded before Flop (didn't bet)
Seat 5: sunmt showed [4c Ac] and won ($0.09) with two pair, Kings and Fours
Seat 6: rideraa folded before Flop (didn't bet)
Seat 7: McMendes mucked [9c Js]
Seat 8: tranemaster (button) mucked [Td Ad]



PokerStars Game #24447549364:  Hold'em No Limit ($0.01/$0.02) - 2009/01/30 22:26:19 ET
Table 'Adalberta III' 9-max Seat #1 is the button
Seat 1: cjordan3 ($1.85 in chips) 
Seat 2: BIGMONMAN ($0.96 in chips) 
Seat 4: Vika76 ($2 in chips) 
Seat 5: sunmt ($2.70 in chips) 
Seat 6: rideraa ($6.19 in chips) 
Seat 7: McMendes ($1.98 in chips) 
Seat 8: tranemaster ($3.14 in chips) 
BIGMONMAN: posts small blind $0.01
Vika76: posts big blind $0.02
*** HOLE CARDS ***
Dealt to sunmt [3h 9s]
sunmt: folds 
sunmt is sitting out
rideraa: folds 
McMendes: folds 
tranemaster: calls $0.02
cjordan3: calls $0.02
X-146 joins the table at seat #9 
BIGMONMAN: raises $0.02 to $0.04
Vika76: calls $0.02
tranemaster: calls $0.02
cjordan3: calls $0.02
*** FLOP *** [5d 6d 6s]
BIGMONMAN: checks 
Vika76: checks 
tranemaster: checks 
cjordan3: checks 
*** TURN *** [5d 6d 6s] [2c]
BIGMONMAN: checks 
Vika76: bets $0.10
tranemaster: folds 
cjordan3: folds 
BIGMONMAN: calls $0.10
*** RIVER *** [5d 6d 6s 2c] [5s]
BIGMONMAN: checks 
Vika76: bets $1.86 and is all-in
BIGMONMAN: folds 
Uncalled bet ($1.86) returned to Vika76
Vika76 collected $0.36 from pot
Vika76: doesn't show hand 
*** SUMMARY ***
Total pot $0.36 | Rake $0 
Board [5d 6d 6s 2c 5s]
Seat 1: cjordan3 (button) folded on the Turn
Seat 2: BIGMONMAN (small blind) folded on the River
Seat 4: Vika76 (big blind) collected ($0.36)
Seat 5: sunmt folded before Flop (didn't bet)
Seat 6: rideraa folded before Flop (didn't bet)
Seat 7: McMendes folded before Flop (didn't bet)
Seat 8: tranemaster folded on the Turn